аба-вязалася	абавязалася
вбввяэвны	абавязаны
абавя-зацельстваў	абавязацельстваў
абавяза-цельствы	абавязацельствы
абавяэацельствы	абавязацельствы
абавяз-кам	абавязкам
абавяз-кова	абавязкова
абаяязкова	абавязкова
абапіраючы-ся	абапіраючыся
аба-раніць	абараніць
абаро-ну	абарону
аба-ронцаў	абаронцаў
абедэен-ны	абедзенны
аб'-ём	аб'ём
абко-ма	абкома
аб-ласнога	абласнога
абласно-га	абласнога
аб-ласной	абласной
абла-сны	абласны
аб-лёту	аблёту
аб-лічча	аблічча
абля-цеў	абляцеў
аб-меркаваннем	абмеркаваннем
абмеркавань	абмеркаваць
вбо	або
лбо	або
абслугоў-вання	абслугоўвання
абста-вінах	абставінах
абсталяван-не	абсталяванне
абсталяван-ня	абсталявання
абстаноўны	абстаноўцы
абста-ноўцы	абстаноўцы
абстаноў-цы	абстаноўцы
абуралі-ся	абураліся
аб'яд-нанай	аб'яднанай
аб'-яднанне	аб'яднанне
аб'-яднання	аб'яднання
абя-цалі	абяцалі
авало-дання	авалодання
авалодан-ня	авалодання
авангар-дзе	авангардзе
аван-тур	авантур
авія-цыі	авіяцыі
авіяцый-ным	авіяцыйным
ага-пкі	агапкі
агенц-тва	агенцтва
агітаныі	агітацыі
вгітбрыгвдв	агітбрыгада
аглял	агляд
вг-ляду	агляду
аг-ні	агні
агра-ном	аграном
аг-ранома	агранома
агуль-ных	агульных
агур-кі	агуркі
адбі-ліся	адбіліся
ад-будзецца	адбудзецца
адбу-дзецца	адбудзецца
ад-бываецца	адбываецца
адбывасцца	адбываецца
албываецца	адбываецца
адбы-ваюцца	адбываюцца
ад-былася	адбылася
ядбылася	адбылася
ад-быліся	адбыліся
адбы-ліся	адбыліся
адбылі-ся	адбыліся
албыліся	адбыліся
адбы-лося	адбылося
адбыло-ся	адбылося
ад-быўся	адбыўся
адбыў-ся	адбыўся
вдбыўся	адбыўся
вд-быўся	адбыўся
ад-быцца	адбыцца
адда-ваць	аддаваць
алдаецца	аддаецца
адлаў	аддаў
ал-даць	аддаць
аддзе-ла	аддзела
аддзелв	аддзела
аддзсла	аддзела
аддэела	аддзела
аддзя-ленне	аддзяленне
аддзялен-не	аддзяленне
алдзяленні	аддзяленні
адлін	адзін
адэін	адзін
алзін	адзін
вдзін	адзін
адзімы	адзіны
адэіным	адзіным
адэначае	адзначае
ад-значаюць	адзначаюць
адзна-чаюць	адзначаюць
адзначынь	адзначыць
ад-значыць	адзначыць
адзна-чыць	адзначыць
адкаэ	адказ
алказ	адказ
ад-казаў	адказаў
алказаў	адказаў
ад-казвае	адказвае
ад-казваюць	адказваюць
ад-казнаснь	адказнасць
адказ-наснь	адказнасць
адкаэны	адказны
ад-каэны	адказны
адкаэу	адказу
алказу	адказу
адкры-вае	адкрывае
адкры-ваецца	адкрываецца
алкрылася	адкрылася
ад-крыта	адкрыта
алкрыта	адкрыта
ал-крыта	адкрыта
ад-крыты	адкрыты
адкры-ты	адкрыты
алкрыты	адкрыты
ад-крытым	адкрытым
алкрытым	адкрытым
ад-крытыя	адкрытыя
ад-крыў	адкрыў
алкрыў	адкрыў
ад-крыццяў	адкрыццяў
алкуль	адкуль
адлюстра-ванне	адлюстраванне
адлю-стравання	адлюстравання
аллюстраваны	адлюстраваны
ад-люстроўвае	адлюстроўвае
адлюстроў-вае	адлюстроўвае
адлю-строўвайце	адлюстроўвайце
адлюстроўваюнь	адлюстроўваюць
адлю-строўваюць	адлюстроўваюць
ад-моўна	адмоўна
адмоў-нага	адмоўнага
адмоўна-га	адмоўнага
ад-на	адна
аднв	адна
адня	адна
ална	адна
вдна	адна
здна	адна
лдна	адна
ад-наго	аднаго
адна-го	аднаго
адпаго	аднаго
алнаго	аднаго
лднаго	аднаго
ад-нак	аднак
Аднвк	Аднак
Аднзк	аднак
Алнак	Аднак
алнак	аднак
ад-наму	аднаму
алнаму	аднаму
алначасова	адначасова
ад-несці	аднесці
ад-но	адно
ално	адно
ядно	адно
ад-ной	адной
Алной	Адной
алной	адной
адной-чы	аднойчы
Алнойчы	Аднойчы
адносі-нах	адносінах
ад-носіны	адносіны
алносіны	адносіны
алну	адну
ал-ну	адну
ад-ны	адны
Алны	Адны
адмым	адным
аднмм	адным
ад-ным	адным
алным	адным
лдным	адным
адпавя-дае	адпавядае
адпавядас	адпавядае
адпа-чываў	адпачываў
ад-пачынак	адпачынак
адначынку	адпачынку
адна-чынку	адпачынку
ад-пачынку	адпачынку
адпачын-ку	адпачынку
адпра-віць	адправіць
адпраўле-ны	адпраўлены
ад-разу	адразу
адраэу	адразу
алразу	адразу
вдразу	адразу
адрас-нае	адраснае
ад-стайвае	адстайвае
адста-ласці	адсталасці
адста-лую	адсталую
адста-ялі	адстаялі
адсутнаснь	адсутнасць
адсутні-чае	адсутнічае
Алсюль	Адсюль
аду-кацыю	адукацыю
адука-цыю	адукацыю
адукацы-яй	адукацыяй
ад-чуваецца	адчуваецца
адчува-ецца	адчуваецца
адчувасцца	адчуваецца
алчуваецца	адчуваецца
алчуваеш	адчуваеш
ад-чуваў	адчуваў
алчуваць	адчуваць
ад-чуваю	адчуваю
адчуваюнь	адчуваюць
вдчулі	адчулі
ад-чуць	адчуць
ады-шлі	адышлі
ажыццяві-лі	ажыццявілі
ажыццяў-ленне	ажыццяўленне
ажыццяўленнс	ажыццяўленне
ажыццяў-ленні	ажыццяўленні
ажыц-цяўлення	ажыццяўлення
АзІІ	Азіі
аэначае	азначае
айчын-най	айчыннай
Айчыннвй	Айчыннай
Айчыннлй	Айчыннай
акадэ-міі	акадэміі
Акалэміі	Акадэміі
акалэміка	акадэміка
аказань	аказаць
ак-варэлі	акварэлі
акі-янам	акіянам
акты-вістаў	актывістаў
ак-тыўнага	актыўнага
актыўна-га	актыўнага
актыў-ны	актыўны
вктыўны	актыўны
ак-тыўнымі	актыўнымі
актыўны-мі	актыўнымі
акцср	акцёр
акнёра	акцёра
акнёрам	акцёрам
акнёры	акцёры
алс	але
вле	але
Лле	але
Ллс	але
але-ся	алеся
алім-піяда	алімпіяда
алоўні-каў	алоўнікаў
аляксанлр	аляксандр
Апяксандр	Аляксандр
аляк-сандра	аляксандра
Аляксанлра	Аляксандра
аляк-свндрв	аляксандра
лляк-сандра	аляксандра
аляк-сеевіч	аляксеевіч
аляксее-віч	аляксеевіч
аляксесвіч	аляксеевіч
аляк-сеевічу	аляксеевічу
аляксееві-чу	аляксеевічу
аля-ксей	аляксей
Аляксся	Аляксея
амзль	амаль
амлль	амаль
амяль	амаль
лмаль	амаль
ямаль	амаль
амерыкан-скага	амерыканскага
аме-рыканскай	амерыканскай
амерыкан-скімі	амерыканскімі
амерыкан-скіх	амерыканскіх
амерыкан-скія	амерыканскія
аме-рыкі	амерыкі
амеры-кі	амерыкі
амс-рыкі	амерыкі
Амерыны	Амерыцы
ана-толь	анатоль
анл-толя	анатоля
АнглІІ	Англіі
англій-скай	англійскай
Анлрэй	Андрэй
ан-тон	антон
ан-тонаў	антонаў
ан-тыкамунізма	антыкамунізма
апавя-дае	апавядае
апавядан-не	апавяданне
апавяданнс	апавяданне
апавя-ланне	апавяданне
апавя-данні	апавяданні
апавядзнні	апавяданні
апавяланні	апавяданні
апа-вядання	апавядання
апавялання	апавядання
апавя-данняў	апавяданняў
апавяланняў	апавяданняў
апавялан-няў	апавяданняў
апавяланнях	апавяданнях
апа-раты	апараты
апладысмен-таў	апладысментаў
анладысменты	апладысменты
апла-дысменты	апладысменты
апладыс-менты	апладысменты
апладысмен-ты	апладысменты
апла-дысмснты	апладысменты
апладысмсн-ты	апладысменты
аплалысменты	апладысменты
Аплалысменты	Апладысменты
ап-лата	аплата
апоаесці	аповесці
аповесні	аповесці
аповеспі	аповесці
апо-весці	аповесці
аповссці	аповесці
апояесці	аповесці
лповесці	аповесці
Аповеснь	Аповесць
апо-весць	аповесць
аповссць	аповесць
Аповссць	Аповесць
апояесць	аповесць
яповесць	аповесць
апош-ні	апошні
лпошні	апошні
апош-ніх	апошніх
апош-нія	апошнія
впошнія	апошнія
япошнія	апошнія
апош-няга	апошняга
апош-няй	апошняй
апра-цоўку	апрацоўку
апярэджва-юць	апярэджваюць
аран-бургу	аранбургу
арбі-ту	арбіту
арбіцс	арбіце
ар-ганізавалі	арганізавалі
аргані-заваны	арганізаваны
арганіза-ваў	арганізаваў
арганіза-ваць	арганізаваць
ар-ганізатар	арганізатар
арганіза-тары	арганізатары
арганізаныі	арганізацыі
арга-нізацыі	арганізацыі
аргані-зацыі	арганізацыі
ар-ганіэацыі	арганізацыі
арга-ніэацыі	арганізацыі
арганізаный	арганізацый
арга-нізацый	арганізацый
арганізацын	арганізацый
арганізаныя	арганізацыя
арганіэа-цыя	арганізацыя
ар-ганізацыяй	арганізацыяй
арганізаныях	арганізацыях
арганіэм	арганізм
арга-нічна	арганічна
ар-генціне	аргенціне
арген-ціне	аргенціне
аргенці-ны	аргенціны
аркадэь	аркадзь
арксстр	аркестр
ар-кестра	аркестра
аркестрв	аркестра
арке-страм	аркестрам
арксстрам	аркестрам
яркестрам	аркестрам
аркестрау	аркестраў
ар-кестраў	аркестраў
ар-мію	армію
ар-мянскай	армянскай
армян-скай	армянскай
вртыкул	артыкул
врты-кул	артыкул
арты-куле	артыкуле
артыкулс	артыкуле
вртыкулы	артыкулы
ар-тыст	артыст
нртыст	артыст
ар-тыста	артыста
арты-ста	артыста
артыстл	артыста
артыстаі	артыстам
артыс-там	артыстам
артыста-мі	артыстамі
артысгаў	артыстаў
ар-тыстаў	артыстаў
арты-стаў	артыстаў
артыс-таў	артыстаў
вртыстаў	артыстаў
артыст-ка	артыстка
артыгты	артысты
ар-тыгты	артысты
ар-тысты	артысты
арты-сты	артысты
артыс-ты	артысты
лртысты	артысты
пртысты	артысты
ар-фаграфічны	арфаграфічны
арфа-графічны	арфаграфічны
арфаграфіч-ны	арфаграфічны
арфагра-фічным	арфаграфічным
архе-алагічныя	археалагічныя
арцслі	арцелі
врце-лі	арцелі
ар-шанскага	аршанскага
а-рыі	арыі
аса-біста	асабіста
асабіс-тае	асабістае
Асабліаа	Асабліва
асабліаа	асабліва
асаб-ліва	асабліва
асаблі-ва	асабліва
асаблівя	асабліва
Асабліна	Асабліва
асабліна	асабліва
асабліяа	асабліва
ясабліва	асабліва
асабліва-га	асаблівага
асаб-лівай	асаблівай
асаблі-вай	асаблівай
асаб-лівасці	асаблівасці
асаблі-васці	асаблівасці
асаблівас-ці	асаблівасці
асабліваснямі	асаблівасцямі
асаблі-выя	асаблівыя
асва-енне	асваенне
асва-енні	асваенні
ас-ваення	асваення
ас-войвае	асвойвае
ас-вятленне	асвятленне
асі-пенкі	асіпенкі
ас-нова	аснова
асно-ву	аснову
асноў-нага	асноўнага
асноў-най	асноўнай
асноў-ная	асноўная
ас-ноўных	асноўных
асноў-ных	асноўных
асоб-ныя	асобныя
Асошызйтэд	Асошыэйтэд
ас-татняе	астатняе
асу-анскай	асуанскай
асуджа-ны	асуджаны
асу-джаючы	асуджаючы
асця-рожна	асцярожна
'атмасфера	атмасфера
атрала	атрада
атрак-цыёны	атракцыёны
ат-рымала	атрымала
атры-мала	атрымала
атры-маных	атрыманых
атры-маў	атрымаў
атрымяў	атрымаў
атрымань	атрымаць
ат-рымлівае	атрымлівае
атрым-ліваю	атрымліваю
ау-тар	аутар
аўро-ры	аўроры
аўта-завода	аўтазавода
аўтаза-вода	аўтазавода
аўталавода	аўтазавода
аўтамабілебу-даўнікоў	аўтамабілебудаўнікоў
аўта-мабілі	аўтамабілі
аў-тамабільным	аўтамабільным
аўта-матычных	аўтаматычных
аўта-машыны	аўтамашыны
аўтама-шыны	аўтамашыны
вўта-номных	аўтаномных
аўтвр	аўтар
яўтара	аўтара
аўта-рам	аўтарам
аўта-раў	аўтараў
аў-тарытэт	аўтарытэт
аўтары-тэт	аўтарытэт
аўтаса-мазвала	аўтасамазвала
аўта-самазвалы	аўтасамазвалы
аўтасама-звалы	аўтасамазвалы
аўто-бусы	аўтобусы
афармлен-не	афармленне
афармленнс	афармленне
афар-мленні	афармленні
афарм-ленні	афармленні
афармлеііня	афармлення
афар-млення	афармлення
афіцэ-ра	афіцэра
афіцэ-рамі	афіцэрамі
афор-міць	аформіць
афры-канскія	афрыканскія
аф-рыкі	афрыкі
ах-вотна	ахвотна
ахоны	аховы
ба-гаты	багаты
бага-ты	багаты
бага-тым	багатым
багаты-рова	багатырова
багац-це	багацце
ба-гацці	багацці
багац-цяў	багаццяў
Баглановіч	Багдановіч
ба-зу	базу
баэу	базу
баэы	базы
бай-цоў	байцоў
ба-ку	баку
балга-рыя	балгарыя
балстных	балетных
ба-лету	балету
бале-ту	балету
ба-лота	балота
ба-лоты	балоты
бало-ты	балоты
бало-це	балоце
баль-ніц	бальніц
баль-ніцы	бальніцы
бальні-цы	бальніцы
ба-рацьба	барацьба
бараць-ба	барацьба
бараньбе	барацьбе
барапьбе	барацьбе
ба-рацьбе	барацьбе
барацьбс	барацьбе
бараць-бітоў	барацьбітоў
бараньбу	барацьбу
барань-бу	барацьбу
барапьбу	барацьбу
барапь-бу	барацьбу
ба-рацьбу	барацьбу
бараньбы	барацьбы
бараць-бы	барацьбы
бярацьбы	барацьбы
барта-шэвіч	барташэвіч
барташэ-віч	барташэвіч
ба-рыс	барыс
баталь-ён	батальён
батанічна-га	батанічнага
бахмай-ер	бахмайер
бацькз	бацька
баць-коў	бацькоў
бача-чы	бачачы
ба-чым	бачым
бячым	бачым
бя-чым	бачым
ба-чыў	бачыў
бячыў	бачыў
бачыне	бачыце
бачынь	бачыць
бачыпь	бачыць
ба-чыць	бачыць
баялі-ся	баяліся
бая-ніста	баяніста
баяў-ся	баяўся
баяшіа	баяцца
беэ	без
бсз	без
безу-моўна	безумоўна
беэумоўна	безумоўна
белару-са	беларуса
бела-русаў	беларусаў
бсларусаў	беларусаў
бе-ларусі	беларусі
бела-русі	беларусі
белару-сі	беларусі
Белврусі	Беларусі
белвру-сі	беларусі
белярусі	беларусі
Бепарусі	Беларусі
бо-ларусі	беларусі
бола-русі	беларусі
бсларусі	беларусі
веларусі	беларусі
вела-русі	беларусі
б^арускаіа	беларускага
бе-ларускага	беларускага
бела-рускага	беларускага
беларуска-га	беларускага
белврускага	беларускага
белярускага	беларускага
бсларускага	беларускага
веларускага	беларускага
БЕЛАРСКДЙ	беларускай
беларускаіі	беларускай
бе-ларускай	беларускай
бела-рускай	беларускай
белару-скай	беларускай
беларус-кай	беларускай
беларускан	беларускай
беларускяй	беларускай
белврускай	беларускай
беллрускай	беларускай
Беллрускай	Беларускай
белярускай	беларускай
бсларускай	беларускай
бс-ларускай	беларускай
бсларус-кай	беларускай
беларус-каму	беларускаму
бе-ларуская	беларуская
бела-руская	беларуская
беларус-кая	беларуская
белв-руская	беларуская
бсларуская	беларуская
беллрускі	беларускі
Бсларускі	Беларускі
веларускі	беларускі
вела-рускі	беларускі
бела-рускім	беларускім
беларус-кім	беларускім
бсларускім	беларускім
бе-ларускімі	беларускімі
белврускімі	беларускімі
бсла-рускімі	беларускімі
бсларускі-мі	беларускімі
бе-ларускіх	беларускіх
бела-рускіх	беларускіх
белару-скіх	беларускіх
беларус-кіх	беларускіх
белврускіх	беларускіх
белв-рускіх	беларускіх
бсларускіх	беларускіх
бслару-скіх	беларускіх
бела-рускія	беларускія
белярускія	беларускія
бсларускія	беларускія
бслару-скія	беларускія
беларус-кую	беларускую
белярускую	беларускую
бсларускую	беларускую
бсларусы	беларусы
бела-русь	беларусь
Белврусь	Беларусь
Веларусь	Беларусь
веларусь-	беларусь
Беларусь2	Беларусь 2
беларусь-фільм	беларусьфільм
Белгародекая	Белгародская
велы	белы
бен-гальскім	бенгальскім
беражлі-ва	беражліва
бсс	бес
бес-працоўе	беспрацоўе
беэ-умоўна	беэумоўна
бібліятзк	бібліятэк
біб-ліятэк	бібліятэк
біблінтэ-ка	бібліятэка
бібліягэка	бібліятэка
бібліятзка	бібліятэка
біб-ліятэка	бібліятэка
біблія-тэка	бібліятэка
бібліятэ-ка	бібліятэка
біблія-тэкв	бібліятэка
біб-ліятэкл	бібліятэка
біблія-тэкя	бібліятэка
бібліягэкі	бібліятэкі
біб-ліятэкі	бібліятэкі
біблія-тэкі	бібліятэкі
бібліятэ-кі	бібліятэкі
бі-бліятэку	бібліятэку
біб-ліятэку	бібліятэку
біблі-ятэку	бібліятэку
бібліятзцы	бібліятэцы
бібліятчцы	бібліятэцы
бібліятэны	бібліятэцы
блі-жэйшы	бліжэйшы
бліжэй-шыя	бліжэйшыя
бліэка	блізка
бліэкіх	блізкіх
бліэкія	блізкія
бло-каў	блокаў
блуд-ніцы	блудніцы
болын	больш
болып	больш
больні	больш
бопьш	больш
боль-шасць	большасць
большменш	больш-менш
боль-шы	большы
большы-мі	большымі
бпм-бы	бомбы
Ворман	Борман
вра-зіліі	бразіліі
брата-мі	братамі
брат-ніх	братніх
брат-няй	братняй
бра-тоў	братоў
бра-ту	брату
бра-шур	брашур
Броўкв	Броўка
Вроўка	Броўка
брыга-д	брыгад
брыга-да	брыгада
брыга-дзе	брыгадзе
брыга-ды	брыгады
брыгалы	брыгады
брыгвды	брыгады
брыглды	брыгады
бры-ля	брыля
Брэснкага	Брэсцкага
брэсц-кай	брэсцкай
всср	бсср
бу-даваў	будаваў
буда-ваць	будаваць
бу-даўніка	будаўніка
булаўнікі	будаўнікі
бу-даўнікоў	будаўнікоў
будаўні-коў	будаўнікоў
будвўнікоў	будаўнікоў
будвўні-коў	будаўнікоў
будаўнінтва	будаўніцтва
будаўніцгва	будаўніцтва
будаўніцтаа	будаўніцтва
будаў-ніцтаа	будаўніцтва
бу-даўніцтва	будаўніцтва
будаў-ніцтва	будаўніцтва
будаўні-цтва	будаўніцтва
будаўніц-тва	будаўніцтва
будаўніцтвв	будаўніцтва
будаўніцтна	будаўніцтва
будаўпіцтва	будаўніцтва
булаўніцтва	будаўніцтва
будаў-ніцтве	будаўніцтве
будаўніцтвс	будаўніцтве
будаў-нічага	будаўнічага
бу-даўнічыя	будаўнічыя
будае	будзе
бу-дзе	будзе
будзс	будзе
будэе	будзе
бу-дэе	будзе
булзе	будзе
бу-лзе	будзе
бу-дзем	будзем
будзсм	будзем
бу-дэем	будзем
бу-дзеш	будзеш
бу-доўлі	будоўлі
булоўлі	будоўлі
бу-доўлях	будоўлях
буд-трэста	будтрэста
бу-дуе	будуе
будуем-ся	будуемся
будунь	будуць
бу-дуць	будуць
булуць	будуць
буду-чае	будучае
бу-дучыні	будучыні
булучыні	будучыні
бу-дучыню	будучыню
будучы-ню	будучыню
будучы-ня	будучыня
бу-дучых	будучых
будукшь	будуюць
буду-юць	будуюць
бу-дынак	будынак
буды-нак	будынак
бу-дынка	будынка
бу-дынкаў	будынкаў
будын-каў	будынкаў
булынкаў	будынкаў
бу-дынку	будынку
будын-ку	будынку
буй-нейшае	буйнейшае
буйней-шых	буйнейшых
бу-лаўка	булаўка
бу-ракоў	буракоў
бураў-кіна	бураўкіна
бур-жуазная	буржуазная
буржу-азным	буржуазным
буржуаз-ных	буржуазных
буржу-азныя	буржуазныя
бур-ныя	бурныя
Вурныя	Бурныя
БУТАКОУ	Бутакоў
бм	бы
бьі	бы
быаае	бывае
бы-вае	бывае
бывас	бывае
бываюпь	бываюць
бы-ваюць	бываюць
бы-ла	была
былв	была
былл	была
быля	была
бы-лі	былі
бмло	было
бы-ло	было
бы-лы	былы
бы-лых	былых
бмў	быў
быу	быў
бьіў	быў
быішам	быццам
бынцам	быццам
быцнам	быццам
быц-цам	быццам
быццям	быццам
бышіам	быццам
бмць	быць
бынь	быць
быпь	быць
бьшь	быць
бю-ро	бюро
бя-дзе	бядзе
бяду-лі	бядулі
Бялулі	Бядулі
бязмсж	бязмеж
бяз-межная	бязмежная
бя-лінскаму	бялінскаму
бя-розаўскай	бярозаўскай
бяруіша	бяруцца
бярэшіа	бярэцца
бяс-пекі	бяспекі
бяспе-кі	бяспекі
бяспрыкладмы	бяспрыкладны
бяспрыклад-ны	бяспрыкладны
бяс-спрэчна	бясспрэчна
ва-енных	ваенных
ваен-ных	ваенных
важ-насці	важнасці
важ-ная	важная
важ-нейшых	важнейшых
ввйну	вайну
вайііы	вайны
вайнм	вайны
вай-ны	вайны
ввйны	вайны
взйны	вайны
влйны	вайны
вяйны	вайны
вяй-ны	вайны
яайны	вайны
вакалыіыя	вакальныя
ва-кол	вакол
вала-вая	валавая
ва-лавой	валавой
вала-вой	валавой
ва-лакна	валакна
валеры-ка	валерыка
ва-лы	валы
ва-ля	валя
Валянніна	Валянціна
валян-ціна	валянціна
валянці-ны	валянціны
аам	вам
ва-мі	вамі
влннаў	ваннаў
ван-ны	ванны
ваііны	вапны
вярта	варта
ва-рыянтаў	варыянтаў
варыян-ты	варыянты
ва-сіль	васіль
Влсіль	Васіль
ва-сільевіча	васільевіча
вачы-ма	вачыма
ввш	ваш
аашу	вашу
веда-ла	ведала
всдалі	ведалі
вс-далі	ведалі
аедаў	ведаў
ве-даў	ведаў
велаў	ведаў
всдаў	ведаў
недаў	ведаў
ведаііь	ведаць
ве-даць	ведаць
велаць	ведаць
всдаць	ведаць
ве-даю	ведаю
всдаю	ведаю
ведаюнь	ведаюць
ве-даюць	ведаюць
ведвюць	ведаюць
всдаюць	ведаюць
ве-жу	вежу
велізар-нае	велізарнае
ве-лізарнай	велізарнай
ве-лічна	велічна
вслічны	велічны
веліч-ных	велічных
аельмі	вельмі
вель-мі	вельмі
вольмі	вельмі
всльмі	вельмі
нельмі	вельмі
пельмі	вельмі
яельмі	вельмі
венгер-скай	венгерскай
венгрыі	венгрыі
ве-ра	вера
веря	вера
Всра	Вера
аерасня	верасня
всрасня	верасня
ве-раць	вераць
всрным	верным
аерш	верш
всрш	верш
аерша	верша
всрша	верша
всршам	вершам
аершаў	вершаў
всршаў	вершаў
яершаў	вершаў
першах	вершах
аершы	вершы
вершм	вершы
всршы	вершы
вср-шы	вершы
Всры	Веры
вёсвк	вёсак
весе-ла	весела
вёс-ках	вёсках
вескі	вёскі
вёс-кі	вёскі
всскі	вёскі
нёскі	вёскі
вёс-цы	вёсцы
ветэра-наў	ветэранаў
вечвр	вечар
всчар	вечар
нечар	вечар
всчара	вечара
вечара-мі	вечарамі
ве-чары	вечары
веча-ры	вечары
всчары	вечары
нечары	вечары
ві-давочна	відавочна
ві-даў	відаў
відань	відаць
ві-даць	відаць
відлць	відаць
відяць	відаць
вілаць	відаць
ві-лаць	відаць
яідаць	відаць
ВІктар	Віктар
вік-тара	віктара
він-шавалі	віншавалі
вінша-валі	віншавалі
він-шаванне	віншаванне
він-шую	віншую
він-шуюць	віншуюць
віншу-юць	віншуюць
ві-таць	вітаць
ві-таю	вітаю
вітры-ны	вітрыны
ві-цебск	віцебск
Віцсбск	Віцебск
Віцсбскага	Віцебскага
ві-цебскай	віцебскай
Віцебсквй	Віцебскай
Віцсбскай	Віцебскай
Вінебску	Віцебску
вобласні	вобласці
вобласпі	вобласці
воб-ласці	вобласці
воблас-ці	вобласці
вобласці-	вобласці
воблвсці	вобласці
вобллсці	вобласці
воб-ласць	вобласць
вобраэ	вобраз
воб-раэ	вобраз
нобраз	вобраз
яобраз	вобраз
аобраза	вобраза
воб-раза	вобраза
вобраэа	вобраза
вобра-замі	вобразамі
во-бразаў	вобразаў
вобраэаў	вобразаў
воб-разная	вобразная
вобра-зы	вобразы
вобраэы	вобразы
вожыкв	вожыка
возс	возе
возсра	возера
во-зерам	возерам
воі-наў	воінаў
вой-скі	войскі
воклалка	вокладка
вок-ладках	вокладках
воклад-ках	вокладках
вок-ладкі	вокладкі
воклад-кі	вокладкі
во-клічы	воклічы
вок-ны	вокны
волыіы	вольны
воль-ны	вольны
воль-ныя	вольныя
воль-скага	вольскага
во-лю	волю
воныт	вопыт
во-пыт	вопыт
во-пытнаму	вопытнаму
вопы-ту	вопыту
вопыцс	вопыце
во-рагам	ворагам
во-рагамі	ворагамі
ворага-мі	ворагамі
во-рагі	ворагі
во-сем	восем
во-сені	восені
вост-рую	вострую
вост-ры	востры
аось	вось
нось	вось
аочы	вочы
во-чы	вочы
ву-ліца	вуліца
вулінах	вуліцах
вулі-ііы	вуліцы
вуліны	вуліцы
ву-ліцы	вуліцы
вулі-цы	вуліцы
нуліцы	вуліцы
вус-ны	вусны
ву-чань	вучань
ву-чацца	вучацца
вучац-ца	вучацца
вучнёў-скага	вучнёўскага
вуч-няў	вучняў
ву-чоны	вучоны
ву-чоным	вучоным
вучо-ным	вучоным
вучо-нымі	вучонымі
вучоны-мі	вучонымі
вучо-ных	вучоных
вучо-ныя	вучоныя
ву-чылішча	вучылішча
вучылі-шча	вучылішча
вучы-лішчы	вучылішчы
вучылі-шчы	вучылішчы
вучыў-ся	вучыўся
вучы-цеся	вучыцеся
аучыцца	вучыцца
вучыіша	вучыцца
ву-чыцца	вучыцца
вучыц-ца	вучыцца
вучышіа	вучыцца
ву-чэнне	вучэнне
вы-бачайце	выбачайце
вы-бралі	выбралі
выбра-нае	выбранае
вы-вучае	вывучае
вы-вучаюць	вывучаюць
выву-чыць	вывучыць
вы-вучэння	вывучэння
вы-гляд	выгляд
выглял	выгляд
вы-глядзе	выглядзе
выглядзс	выглядзе
выглялу	выгляду
выгнан-не	выгнанне
выдавентва	выдавецтва
выда-вецтва	выдавецтва
выдавецт-ва	выдавецтва
выдавсцтва	выдавецтва
вылавецтва	выдавецтва
выланне	выданне
выланні	выданні
выдапня	выдання
вылання	выдання
выдан-няў	выданняў
выланняў	выданняў
выдат-на	выдатна
вылатна	выдатна
вы-датнага	выдатнага
выдатнас	выдатнае
вылатнай	выдатнай
вы-датную	выдатную
аыдатны	выдатны
вы-датны	выдатны
выдат-ны	выдатны
вылатны	выдатны
выдат-ным	выдатным
вы-датнымі	выдатнымі
вы-датных	выдатных
выдат-ных	выдатных
вылатных	выдатных
выеха-лі	выехалі
выэвалення	вызвалення
выэначыў	вызначыў
вы-значыўся	вызначыўся
вый-шаў	выйшаў
выншаў	выйшаў
выншла	выйшла
выка-заны	выказаны
вы-казаў	выказаў
выказань	выказаць
вы-казаць	выказаць
выкаэаць	выказаць
вы-каэвае	выказвае
выказ-валася	выказвалася
аыканалі	выканалі
выка-нанне	выкананне
выка-наннем	выкананнем
ныкананні	выкананні
выка-наў	выканаў
вы-канаўцаў	выканаўцаў
выквнаўцаў	выканаўцаў
выкв-нвўцвў	выканаўцаў
выканань	выканаць
вы-канаць	выканаць
выка-рыстання	выкарыстання
выкары-стання	выкарыстання
выкарыстань	выкарыстаць
выкары-стаць	выкарыстаць
выкарыстоў-ваючы	выкарыстоўваючы
вы-кладчык	выкладчык
вы-клікалі	выклікалі
вык-лікалі	выклікалі
выклі-каюць	выклікаюць
выклі-каючы	выклікаючы
выключ-на	выключна
вы-ключнай	выключнай
выконвас	выконвае
выконвань	выконваць
выкон-ввць	выконваць
вымпе-лы	вымпелы
выму-шаны	вымушаны
вымуша-ны	вымушаны
вымўшаны	вымушаны
вына-ходцаў	вынаходцаў
ныніку	выніку
выпалках	выпадках
вы-падку	выпадку
выпад-ку	выпадку
ныпадку	выпадку
вы-пісаны	выпісаны
выпраба-ванняў	выпрабаванняў
вы-пускае	выпускае
выпус-каць	выпускаць
аыпускнікі	выпускнікі
вы-пускнікі	выпускнікі
вы-пускнікоў	выпускнікоў
выпуск-нікоў	выпускнікоў
вы-пуску	выпуску
вы-рабаў	вырабаў
выра-баў	вырабаў
вы-разна	выразна
выраз-на	выразна
выраэна	выразна
пыразна	выразна
выраэнасць	выразнасць
вы-рас	вырас
вы-расла	вырасла
вырас-ля	вырасла
вы-раслі	выраслі
вы-рашана	вырашана
вырашань	вырашаць
выра-шаць	вырашаць
вы-рашылі	вырашылі
вырашы-лі	вырашылі
яырашылі	вырашылі
выра-шыў	вырашыў
выра-шыць	вырашыць
вырашэн-не	вырашэнне
вы-рашэння	вырашэння
выра-шэння	вырашэння
вырашэн-ня	вырашэння
нырашэння	вырашэння
вырошчвань	вырошчваць
вы-сакародная	высакародная
высака-родных	высакародных
Рзслухала	выслухала
высо-ка	высока
пысока	высока
вы-сокай	высокай
высокан	высокай
высоклй	высокай
вы-сокі	высокі
вы-сокія	высокія
высо-кія	высокія
высот-най	высотнай
выстаўкл	выстаўка
вы-стаўкі	выстаўкі
выстлўкі	выстаўкі
пыстаўкі	выстаўкі
вы-стаўны	выстаўны
выстраі-ліся	выстраіліся
выстраілі-ся	выстраіліся
вы-ступае	выступае
выступас	выступае
ныступае	выступае
вы-ступала	выступала
вы-ступалі	выступалі
аыступаў	выступаў
выступань	выступаць
высту-паюць	выступаюць
выступа-юць	выступаюць
выстулілі	выступілі
высту-пілі	выступілі
аысту-піў	выступіў
вмступіў	выступіў
высту-піў	выступіў
ныступіў	выступіў
яыступіў	выступіў
выступінь	выступіць
вы-ступіць	выступіць
выступлен-не	выступленне
выступлен-нем	выступленнем
вьіступлен-нем	выступленнем
аыступленні	выступленні
вы-ступленні	выступленні
выступлен-ні	выступленні
высту-пяць	выступяць
вы-творчага	вытворчага
аытворчасці	вытворчасці
вытаорчасці	вытворчасці
вытворчагці	вытворчасці
вы-творчасці	вытворчасці
вытвор-часці	вытворчасці
вытворча-сці	вытворчасці
вытворчаснь	вытворчасць
вытвор-часць	вытворчасць
выхава-ла	выхавала
выхананню	выхаванню
выхааання	выхавання
вы-хавання	выхавання
выхаван-ня	выхавання
выха-ду	выхаду
аыходзіць	выходзіць
вы-ходзіць	выходзіць
ныходзіць	выходзіць
выходзянь	выходзяць
выхоў-вае	выхоўвае
вы-хоўваць	выхоўваць
вы-хоўваюць	выхоўваюць
вышдй	вышай
вы-ше	выше
вы-шэй	вышэй
вышэй-шую	вышэйшую
вы-шэйшыя	вышэйшыя
выявінь	выявіць
выяўляеіша	выяўляецца
вя-дзе	вядзе
вядзецна	вядзецца
аядома	вядома
вндома	вядома
вя-дома	вядома
Вядомв	Вядома
вя-домв	вядома
вядомл	вядома
вядомя	вядома
Вялома	Вядома
вялома	вядома
вя-домага	вядомага
вяломай	вядомай
вяломы	вядомы
вя-домых	вядомых
вядунь	вядуць
вя-ла	вяла
вя-лі	вялі
аялікага	вялікага
вя-лікага	вялікага
вялі-кага	вялікага
вяліка-га	вялікага
вялікяга	вялікага
пялікага	вялікага
вя-лікае	вялікае
вялі-кае	вялікае
вялікас	вялікае
аялікай	вялікай
вялікаіі	вялікай
вя-лікай	вялікай
вялі-кай	вялікай
вялікан	вялікай
вяліквй	вялікай
вя-ліквй	вялікай
Вяліклй	Вялікай
вяліклй	вялікай
вялікяй	вялікай
нялікай	вялікай
пялікай	вялікай
вя-лікаму	вялікаму
вялі-кая	вялікая
Вяліквя	вялікая
вяліквя	вялікая
вялікля	вялікая
вя-лікі	вялікі
вялі-кі	вялікі
пялікі	вялікі
яялікі	вялікі
аялікім	вялікім
вя-лікім	вялікім
вялі-кім	вялікім
пялікім	вялікім
вя-лікімі	вялікімі
аялікіх	вялікіх
вя-лікіх	вялікіх
вя-лікія	вялікія
вялі-кія	вялікія
вялі-кую	вялікую
вялі-ную	вялікую
пялікую	вялікую
яялікую	вялікую
вяр-нуліся	вярнуліся
вярнулі-ся	вярнуліся
вяр-нуўся	вярнуўся
вяр-нуўшыся	вярнуўшыся
вяр-нуцца	вярнуцца
вяр-тацца	вяртацца
вярхоунага	вярхоўнага
вяр-хоўнага	вярхоўнага
вярхоў-нага	вярхоўнага
вясслы	вясёлы
вя-сслы	вясёлы
вяс-на	вясна
вясня	вясна
аясну	вясну
вячэр-нюю	вячэрнюю
вя-чэрняй	вячэрняй
вячэр-няй	вячэрняй
га-варылася	гаварылася
гавары-лася	гаварылася
гава-рылі	гаварылі
гавары-лі	гаварылі
га-варыў	гаварыў
гава-рыў	гаварыў
гавярыў	гаварыў
гапарыў	гаварыў
гаварынь	гаварыць
ганарыць	гаварыць
гаворань	гавораць
гаво-раць	гавораць
гавор-ка	гаворка
гавор-кі	гаворкі
гяворку	гаворку
гаво-рым	гаворым
гаворышіа	гаворыцца
гааорыць	гаворыць
гаворынь	гаворыць
га-ворыць	гаворыць
гаво-рыць	гаворыць
гаворьшь	гаворыць
га-ворьшь	гаворыць
га-норыць	гаворыць
гаяорыць	гаворыць
гяворыць	гаворыць
гага-рын	гагарын
га-га-рын	гагарын
Тагарын	Гагарын
га-гарына	гагарына
гага-рына	гагарына
гагары-на	гагарына
гагарын-а	гагарына
га-гарыну	гагарыну
гага-рыну	гагарыну
гагары-ну	гагарыну
гагары-ным	гагарыным
га-давінай	гадавінай
гада-віны	гадавіны
га-давы	гадавы
га-дзін	гадзін
гадэін	гадзін
га-дэін	гадзін
глдзін	гадзін
гл-дэін	гадзін
га-дэіна	гадзіна
га-дзіны	гадзіны
гадэіны	гадзіны
га-доў	гадоў
Гадуноу	Гадуноў
гадм	гады
га-ды	гады
гвды	гады
гяды	гады
га-зета	газета
газетл	газета
газста	газета
га-эета	газета
газет-ных	газетных
га-зету	газету
газсту	газету
гаэету	газету
газегы	газеты
га-зеты	газеты
газе-ты	газеты
газсты	газеты
газене	газеце
газецо	газеце
газецс	газеце
гаэу	газу
га-лава	галава
га-ласы	галасы
галінс	галіне
гвліне	галіне
галоў-нага	галоўнага
гвлоўквгв	галоўнага
га-лоўнае	галоўнае
галоў-нае	галоўнае
галоў-ная	галоўная
гвлоўны	галоўны
га-лоўным	галоўным
галоў-ным	галоўным
гялоўным	галоўным
га-лоўныя	галоўныя
галь-штук	гальштук
га-ля	галя
га-нарымся	ганарымся
гана-рыцца	ганарыцца
ганллю	гандлю
га-небную	ганебную
ган-чарэнка	ганчарэнка
гара-дах	гарадах
гара-лах	гарадах
гаралок	гарадок
га-радоў	гарадоў
гара-доў	гарадоў
гаралоў	гарадоў
гярадоў	гарадоў
гарад-ская	гарадская
га-радскім	гарадскім
га-радскога	гарадскога
гарадскогл	гарадскога
гаралскога	гарадскога
га-рады	гарады
гара-ды	гарады
гара-чую	гарачую
гарынь	гарыць
гаспалар	гаспадар
гаспа-дарка	гаспадарка
гаснадаркі	гаспадаркі
гас-падаркі	гаспадаркі
гаспа-даркі	гаспадаркі
гаспадар-кі	гаспадаркі
гаспаларкі	гаспадаркі
гас-паларкі	гаспадаркі
гаспвдаркі	гаспадаркі
гас-пвдвркі	гаспадаркі
гаспа-дароў	гаспадароў
гаснадарцы	гаспадарцы
гаспа-дарцы	гаспадарцы
гаспа-дарчым	гаспадарчым
гаспа-дары	гаспадары
гаспада-ры	гаспадары
гаспа-дыня	гаспадыня
глстролі	гастролі
гастроль-ная	гастрольная
гвстроль-нвя	гастрольная
га-стрытах	гастрытах
гас-цей	гасцей
гвсцей	гасцей
га-сцямі	гасцямі
гато-вы	гатовы
гвінсі	гвінеі
геа-графічных	геаграфічных
гек-тараў	гектараў
гекта-раў	гектараў
Генадэь	Генадзь
генсральны	генеральны
гене-ральным	генеральным
генераль-ным	генеральным
гені-яльнай	геніяльнай
гені-яльны	геніяльны
Гсоргій	Георгій
гераі-ню	гераіню
ге-раічнага	гераічнага
ге-раічных	гераічных
гера-ічных	гераічных
гераіч-ных	гераічных
Гсрманіі	Германіі
гер-манію	германію
гер-манскім	германскім
ге-роі	героі
гсроі	героі
ге-рой	герой
Гсрой	Герой
ге-рою	герою
Герол	героя
ге-роя	героя
гсроя	героя
героякасманаўта	героя-касманаўта
гсроямі	героямі
геро-яў	герояў
гсрояў	герояў
гс-рояў	герояў
гі-ганцкі	гіганцкі
гі-старычнай	гістарычнай
гіста-рычная	гістарычная
гістарыч-ная	гістарычная
гі-старычных	гістарычных
гіс-тарычных	гістарычных
гіста-рычныя	гістарычныя
гістарыч-ныя	гістарычныя
гі-сторыі	гісторыі
гіс-торыі	гісторыі
гісто-рыі	гісторыі
гі-сторыю	гісторыю
гі-сторыя	гісторыя
гісто-рыя	гісторыя
гісторы-яй	гісторыяй
гітле-раўскім	гітлераўскім
гітле-раўцамі	гітлераўцамі
гіт-лераўцаў	гітлераўцаў
гіт-лераўцы	гітлераўцы
глеб-ка	глебка
гле-дача	гледача
гледа-ча	гледача
гледа-чамі	гледачамі
глелачамі	гледачамі
глелачоў	гледачоў
гледа-чу	гледачу
гле-дачы	гледачы
глелачы	гледачы
глсдачы	гледачы
глі-ны	гліны
глы-бока	глыбока
глыбо-ка	глыбока
гля-дзець	глядзець
гля-дзіце	глядзіце
глядзянь	глядзяць
гля-дэяць	глядзяць
гнязло	гняздо
го-да	года
годв	года
го-дзе	годзе
годзс	годзе
годэе	годзе
годна-сці	годнасці
годнас-ці	годнасці
*Голас	Голас
го-лас	голас
іолас	голас
го-ласам	голасам
го-лымі	голымі
ГольцМілера	Гольц-Мілера
ГомелІ	Гомелі
го-мельскага	гомельскага
гомельска-га	гомельскага
Гомсльскага	Гомельскага
го-мельскім	гомельскім
го-мельскіх	гомельскіх
гомельшчы-ны	гомельшчыны
го-нар	гонар
гонвр	гонар
гона-рам	гонарам
гонвру	гонару
гон-цы	гонцы
го-рад	горад
горал	горад
горвд	горад
горлд	горад
го-рада	горада
гора-да	горада
горадв	горада
горадя	горада
горала	горада
го-рала	горада
гора-ла	горада
горвда	горада
горлда	горада
го-радам	горадам
го-радзе	горадзе
гора-дзе	горадзе
горадзс	горадзе
горадэе	горадзе
гордас-цю	гордасцю
гор-кага	горкага
горка-га	горкага
Горкагл	Горкага
І'оркага	Горкага
гор-кі	горкі
госні	госці
госнь	госць
гос-ця	госця
грама-дзяніна	грамадзяніна
грамадзя-ніна	грамадзяніна
грамадзян-скага	грамадзянскага
гра-мадзянскай	грамадзянскай
грамадзян-скай	грамадзянскай
гра-мадскага	грамадскага
грамад-скага	грамадскага
грамадска-га	грамадскага
грамалскага	грамадскага
грамад-скай	грамадскай
грамадскаснь	грамадскасць
гра-мадскасцю	грамадскасцю
гра-мадская	грамадская
гра-мадскі	грамадскі
гра-мадскім	грамадскім
грамад-скім	грамадскім
грамалскіх	грамадскіх
грлмадскіх	грамадскіх
грамалскія	грамадскія
грамад-скую	грамадскую
грамадстаа	грамадства
гра-мадства	грамадства
грамад-ства	грамадства
грамадстна	грамадства
грлмад-ства	грамадства
грамадствс	грамадстве
грана-тай	гранатай
гранды-ёзныя	грандыёзныя
грані-цы	граніцы
гра-фікам	графікам
гра-фікі	графікі
гра-шовымі	грашовымі
гро-дзенскага	гродзенскага
Гродзснскага	Гродзенскага
ГродзенскІ	Гродзенскі
гро-дзеншчыны	гродзеншчыны
грод-на	гродна
Гроднл	Гродна
Гролна	Гродна
гро-шай	грошай
гро-шы	грошы
Груэіі	Грузіі
грунтоў-на	грунтоўна
гру-пы	групы
гу-барэвіч	губарэвіч
гурт-коў	гурткоў
гур-ток	гурток
гутар-кі	гутаркі
гу-тарку	гутарку
гутар-ку	гутарку
гу-чання	гучання
гучвць	гучаць
гучынь	гучыць
г»та	гэта
гзта	гэта
гэга	гэта
гэ-та	гэта
гэтв	гэта
гэ-тв	гэта
гэтз	гэта
гэтл	гэта
гэтя	гэта
гэ-тя	гэта
іэта	гэта
І'эта	Гэта
гзтага	гэтага
гэгага	гэтага
гэ-тага	гэтага
гэта-га	гэтага
гэтагв	гэтага
гэтагл	гэтага
гэтагя	гэтага
гэтзга	гэтага
гэтлга	гэтага
гэтае	гэтае
гэ-тае	гэтае
гэтле	гэтае
гзтай	гэтай
гэтаіі	гэтай
гэ-тай	гэтай
гэтан	гэтак
гэта-му	гэтаму
гэ-тая	гэтая
гэтля	гэтая
гэтмя	гэтая
гэтяя	гэтая
гэ-ту	гэту
гэ-тую	гэтую
гзты	гэты
гэ-ты	гэты
гэтьі	гэты
гзтым	гэтым
гэтмм	гэтым
гэ-тым	гэтым
гзтымі	гэтымі
гэ-тымі	гэтымі
гзтых	гэтых
гэтмх	гэтых
гэ-тых	гэтых
гзтыя	гэтыя
гэ-тыя	гэтыя
дабівайнеся	дабівайцеся
да-біліся	дабіліся
дабра-быту	дабрабыту
дабрабы-ту	дабрабыту
давань	даваць
да-ваць	даваць
лаваць	даваць
даведалі-ся	даведаліся
да-ведаўшыся	даведаўшыся
даведаўшы-ся	даведаўшыся
даве-дацца	даведацца
да-водзіцца	даводзіцца
лаводзіцца	даводзіцца
да-волі	даволі
даполі	даволі
даяолі	даволі
дяволі	даволі
лаволі	даволі
давяло-ся	давялося
дявялося	давялося
ла-вялося	давялося
да-гавору	дагавору
дагэ-туль	дагэтуль
да-дзеныя	дадзеныя
да-дому	дадому
ладому	дадому
дазіроў-кі	дазіроўкі
лаказаў	даказаў
да-клад	даклад
даклал	даклад
дакла-дам	дакладам
даклалам	дакладам
да-кладна	дакладна
дак-ладна	дакладна
даклална	дакладна
закончыліся	дакончыліся
дак-трыну	дактрыну
даку-менталыіы	дакументальны
даку-ментальны	дакументальны
дакумен-тальным	дакументальным
дакумен-тальных	дакументальных
да-кументы	дакументы
дакумен-ты	дакументы
лакументы	дакументы
да-ла	дала
далей-шага	далейшага
лалейшым	далейшым
далей-шых	далейшых
лалёка	далёка
далбкае	далёкае
да-лёкія	далёкія
далё-кія	далёкія
да-лес	далес
да-леса	далеса
да-лі	далі
дал-лю	даллю
дамагчы-ся	дамагчыся
дамннструюцца	даманструюцца
да-мах	дамах
да-моў	дамоў
ламоў	дамоў
лямоў	дамоў
да-мы	дамы
да-памагае	дапамагае
дапамагас	дапамагае
дапа-магалі	дапамагалі
лапамагалі	дапамагалі
двпвмвгвць	дапамагаць
дапамага-юць	дапамагаюць
данамагчы	дапамагчы
да-памагчы	дапамагчы
дапамаг-чы	дапамагчы
да-памога	дапамога
да-памогай	дапамогай
дапа-могай	дапамогай
данамогу	дапамогу
да-памогу	дапамогу
дапа-могу	дапамогу
дапамо-гу	дапамогу
двпвмогу	дапамогу
дапа-можа	дапаможа
да-памозе	дапамозе
да-рагія	дарагія
дара-гія	дарагія
дара-гое	дарагое
дарадчы-кам	дарадчыкам
да-рог	дарог
даро-га	дарога
ларога	дарога
даро-гах	дарогах
да-рогу	дарогу
да-розе	дарозе
дарэ-чы	дарэчы
Дярэчы	Дарэчы
даследа-ванні	даследаванні
даследаван-ні	даследаванні
дасле-даванняў	даследаванняў
да-статкова	дастаткова
да-стаўлены	дастаўлены
дастой-най	дастойнай
длстойнай	дастойнай
да-стойную	дастойную
дастой-ную	дастойную
дасяг-ненне	дасягненне
дасяг-неннем	дасягненнем
да-сягненні	дасягненні
дасяг-ненні	дасягненні
дасяг-ненняў	дасягненняў
двсягненняў	дасягненняў
ласягненняў	дасягненняў
дасяг-нулі	дасягнулі
датычьшь	датычыць
даў-но	даўно
лаўно	даўно
да-ходаў	даходаў
да-ходзіць	даходзіць
даюнь	даюць
лаярка	даярка
даяр-кай	даяркай
даа	два
дватры	два-тры
двацца-ці	дваццаці
двац-цаць	дваццаць
лвор	двор
лвух	двух
дзвсры	дзверы
дэвюх	дзвюх
дзс	дзе
дэе	дзе
лзе	дзе
дзейнасні	дзейнасці
дзей-насні	дзейнасці
дзейна-сці	дзейнасці
дзейнвсці	дзейнасці
дзейпасці	дзейнасці
дэейнасці	дзейнасці
дзеіінасць	дзейнасць
дзейнаснь	дзейнасць
дзейнвсць	дзейнасць
дэейнасць	дзейнасць
дзе-ля	дзеля
дзсля	дзеля
дэён	дзён
дзснь	дзень
дэень	дзень
лзень	дзень
дзе-сяткаў	дзесяткаў
дзе-сяткі	дзесяткі
дэесяткі	дзесяткі
дзесяні	дзесяці
дзесянь	дзесяць
дзе-ці	дзеці
дэеці	дзеці
дзе-цям	дзецям
дзсяча	дзеяча
дзея-чоў	дзеячоў
дзсячоў	дзеячоў
дзея-чы	дзеячы
дзіня	дзіця
дзіця-чага	дзіцячага
дзіцяча-га	дзіцячага
дзіцячан	дзіцячай
дзінячым	дзіцячым
дзі-цячых	дзіцячых
дзі-цячыя	дзіцячыя
дзміт-рый	дзмітрый
дзя-куй	дзякуй
дзя-кую	дзякую
дэякую	дзякую
дзя-куючы	дзякуючы
Дэянісаў	Дзянісаў
дзяр-жава	дзяржава
дзяржа-ву	дзяржаву
дзяр-жавы	дзяржавы
дзяржа-вы	дзяржавы
даярзкаўнага	дзяржаўнага
Дэяржаўнага	Дзяржаўнага
дзяр-жаўнае	дзяржаўнае
дзяржаў-нае	дзяржаўнае
дзяр-жаўнай	дзяржаўнай
дзяржаў-най	дзяржаўнай
дзяр-жаўная	дзяржаўная
дзяр-жаўны	дзяржаўны
дзяр-жаўным	дзяржаўным
дзяржаў-ным	дзяржаўным
Дэяржаўным	Дзяржаўным
дзяржаў-ных	дзяржаўных
лзяр-жаўныя	дзяржаўныя
Дэяржынскага	Дзяржынскага
Дзятллў	Дзятлаў
дзяў-чат	дзяўчат
дзяўчвт	дзяўчат
дзяўча-ты	дзяўчаты
Дзяучыь	дзяўчын
дзяў-чына	дзяўчына
Дэяўчына	Дзяўчына
дзяў-чынка	дзяўчынка
Дэяўчынка	Дзяўчынка
дзяў-чынкі	дзяўчынкі
дзяўчы-ну	дзяўчыну
дзяў-чыны	дзяўчыны
дзяўчы-ны	дзяўчыны
дзяней	дзяцей
дзя-ней	дзяцей
дзя-цей	дзяцей
дзяцсй	дзяцей
дзя-цсй	дзяцей
дэяцей	дзяцей
лзяцей	дзяцей
дзянінства	дзяцінства
діія	для
длн	для
лля	для
лнём	днём
лні	дні
лня	дня
доб-ра	добра
Добрл	Добра
добрл	добра
добря	добра
лобра	добра
добрас	добрае
лобрай	добрай
добраўпарадка-ванню	добраўпарадкаванню
доб-рая	добрая
доб-рую	добрую
доб-ры	добры
лобры	добры
доб-рым	добрым
доб-рымі	добрымі
доб-рых	добрых
лобрых	добрых
до-гляду	догляду
дожлж	дождж
док-тар	доктар
локтар	доктар
дола-раў	долараў
до-ма	дома
домв	дома
домл	дома
домя	дома
до-ме	доме
Домс	Доме
доўгв	доўга
доўта	доўга
лоўгі	доўгі
дра-матург	драматург
лраматург	драматург
драма-тургаў	драматургаў
дра-матургі	драматургі
драма-тургі	драматургі
дра-матургіі	драматургіі
лря-мятургіі	драматургіі
драма-тычны	драматычны
дрв-мвтычны	драматычны
драўля-ных	драўляных
драўні-ны	драўніны
друті	другі
лругі	другі
дру-гім	другім
лругім	другім
дру-гія	другія
лругія	другія
другогв	другога
дру-гой	другой
друж-ба	дружба
лружба	дружба
друкар-ні	друкарні
лруку	друку
друкуюццв	друкуюцца
лрэва	дрэва
дрэ-вы	дрэвы
лрэвы	дрэвы
дрэн-на	дрэнна
дрзў	дрэў
лрэў	дрэў
ду-бінка	дубінка
Дубоаы	Дубовы
дуб-рава	дубрава
дуброў-скага	дуброўскага
ду-мак	думак
лумак	думак
лу-мала	думала
дума-лі	думалі
думань	думаць
думкя	думка
лумка	думка
дум-кай	думкай
дум-камі	думкамі
дум-кі	думкі
лумкі	думкі
лумку	думку
дур-ману	дурману
дур-ніца	дурніца
ду-хоўных	духоўных
ду-хоўныя	духоўныя
ду-шой	душой
ду-шу	душу
душм	душы
лушы	душы
ды-візіі	дывізіі
ды-візія	дывізія
лык	дык
дырзктар	дырэктар
ды-рэктар	дырэктар
дырэк-тар	дырэктар
лырэктар	дырэктар
лырэктара	дырэктара
лырэкцыя	дырэкцыя
дысцыплі-ны	дысцыпліны
дыхан-не	дыханне
дэей-насць	дэейнасць
дэка-мерон	дэкамерон
дэкара-тыўных	дэкаратыўных
дэлега-цыі	дэлегацыі
дэлега-цыя	дэлегацыя
дэ-макратыі	дэмакратыі
дэма-кратычнай	дэмакратычнай
дэман-стравацца	дэманстравацца
дэ-манстрацый	дэманстрацый
дэман-страцыя	дэманстрацыя
дэ-путатам	дэпутатам
дэ-путатаў	дэпутатаў
дэ-талі	дэталі
дэта-лямі	дэталямі
ёіі	ён
ермачэн-кі	ермачэнкі
еснь	есць
Еспь	Есць
бсць	ёсць
ёсііь	ёсць
ёснь	ёсць
ёспь	ёсць
ссць	ёсць
еуропы	еўропы
еўро-пы	еўропы
ехань	ехаць
схаць	ехаць
жя	жа
жа-біцкі	жабіцкі
жадас	жадае
жаданнс	жаданне
жаланне	жаданне
жада-юць	жадаюць
жа-лезнай	жалезнай
Жалеэны	Жалезны
жзль	жаль
жлль	жаль
жано-чага	жаночага
жано-чы	жаночы
жан-чын	жанчын
жан-чына	жанчына
жанчы-на	жанчына
жянчына	жанчына
жанчы-ны	жанчыны
жда-нава	жданава
жомка	жонка
жон-ка	жонка
жонкл	жонка
жон-ку	жонку
жонны	жонцы
Жоуты	Жоўты
жмве	жыве
жывс	жыве
жывёлага-доўлі	жывёлагадоўлі
жывёла-гадоўчых	жывёлагадоўчых
жывёлага-доўчых	жывёлагадоўчых
жывё-лы	жывёлы
жы-веш	жывеш
жы-вога	жывога
жывос	жывое
жы-вуць	жывуць
жыяуць	жывуць
жы-вы	жывы
жы-лых	жылых
жыха-ры	жыхары
жыхвры	жыхары
жмццё	жыццё
жыішё	жыццё
жыннё	жыццё
жынцё	жыццё
жыцііё	жыццё
жыцнё	жыццё
жыццб	жыццё
жыцце	жыццё
жыц-цё	жыццё
жыццс	жыццё
жышіё	жыццё
жьіццё	жыццё
жьшцё	жыццё
жыццё-вага	жыццёвага
жыц-цёвым	жыццёвым
жыццё-вых	жыццёвых
жышіёвых	жыццёвых
жыішём	жыццём
жыннём	жыццём
жынцём	жыццём
жыц-цём	жыццём
жыііці	жыцці
жыіші	жыцці
жыцні	жыцці
жыц-ці	жыцці
жышіі	жыцці
жмцця	жыцця
жыііця	жыцця
жыішя	жыцця
жыння	жыцця
жынця	жыцця
жыціія	жыцця
жыцня	жыцця
жыцпя	жыцця
жыццв	жыцця
жыц-ця	жыцця
жышія	жыцця
жыц-цямі	жыццямі
жыцця-радасную	жыццярадасную
жынь	жыць
жыпь	жыць
3	з
эа	за
заа-парку	заапарку
за-атэхнік	заатэхнік
за-барону	забарону
за-будову	забудову
забудо-ву	забудову
забу-довы	забудовы
зя-будовы	забудовы
забывань	забываць
забяспечынь	забяспечыць
за-бяспечыць	забяспечыць
забяспе-чыць	забяспечыць
эабяспечыць	забяспечыць
за-вод	завод
завол	завод
эавод	завод
эа-вод	завод
за-вода	завода
заво-да	завода
завола	завода
запода	завода
злвода	завода
эавода	завода
эа-вода	завода
заво-даў	заводаў
эаводаў	заводаў
эаводах	заводах
заводзс	заводзе
эаводзе	заводзе
за-водскіх	заводскіх
эаводскіх	заводскіх
за-воды	заводы
#ИМЯ?	загаварылі
зага-варыў	загаварыў
эагаду	загаду
за-гадчык	загадчык
эагадчык	загадчык
за-гадчыка	загадчыка
эагалчыка	загадчыка
загадчына	загадчыца
загад-чыца	загадчыца
эагадчыца	загадчыца
загалоў-кам	загалоўкам
за-гінулі	загінулі
задавалыіеннем	задавальненнем
за-даволены	задаволены
зада-волены	задаволены
задаво-лены	задаволены
за-дадзеным	зададзеным
зададзе-ным	зададзеным
эаданне	заданне
за-дання	задання
за-дач	задач
залач	задач
залача	задача
эадача	задача
за-дачай	задачай
за-дачу	задачу
эадачу	задачу
за-дачы	задачы
зада-чы	задачы
эадачы	задачы
задумс	задуме
эадумы	задумы
эайку	зайку
займас	займае
эаймаецца	займаецца
займаюнь	займаюць
займа-юць	займаюць
заканчвас	заканчвае
Заканчэннс	Заканчэнне
заканчэн-ня	заканчэння
эаклі-ку	закліку
за-ключэнне	заключэнне
заключэн-не	заключэнне
эаключэнне	заключэнне
эакона	закона
эаконаў	законаў
закон-чан	закончан
эакончыла	закончыла
за-ла	зала
залсжыць	залажыць залежыць
эалатым	залатым
зв-ле	зале
залежынь	залежыць
зале-жынь	залежыць
за-лічыць	залічыць
эалу	залу
эамежных	замежных
заме-ны	замены
замсст	замест
за-мсст	замест
эамест	замест
за-муж	замуж
заналта	занадта
эаняткаў	заняткаў
эаняткі	заняткі
заня-ты	заняты
за-паветная	запаветная
#ИМЯ?	запаветы
запа-лам	запалам
запатрабаван-ні	запатрабаванні
за-патрабаванняў	запатрабаванняў
запэўняе	запаўняе
за-планавана	запланавана
за-поўнены	запоўнены
за-пуск	запуск
за-пусцілі	запусцілі
за-пытала	запытала
за-ра	зара
за-раз	зараз
зараэ	зараз
за-раэ	зараз
эараз	зараз
эараэ	зараз
эарплаты	зарплаты
эарубежных	зарубежных
зару-бежныя	зарубежныя
эаслугі	заслугі
за-слугоўвае	заслугоўвае
за-служанага	заслужанага
эаслужаны	заслужаны
засна-валыіік	заснавальнік
засна-вальніка	заснавальніка
заснавальні-ка	заснавальніка
за-снавальніку	заснавальніку
застасцца	застаецца
заста-лася	засталася
за-сталіся	засталіся
за-сталося	засталося
эасталося	засталося
эастаўся	застаўся
эастаюцца	застаюцца
зата-іўшы	затаіўшы
за-тое	затое
эатое	затое
эатым	затым
эа-тым	затым
эаўвагі	заўвагі
заўважынь	заўважыць
заўседы	заўсёды
заў-сёды	заўсёды
заўсё-ды	заўсёды
заўсёлы	заўсёды
заўссды	заўсёды
зяўсёды	заўсёды
эаўсёды	заўсёды
эа-ўсёды	заўсёды
эаў-сёды	заўсёды
заўтрв	заўтра
эаўтра	заўтра
заўтраш-ні	заўтрашні
заха-валіся	захаваліся
за-хаванне	захаванне
за-хавання	захавання
заха-дзе	захадзе
заха-піць	захапіць
эахапленне	захапленне
за-хапленнем	захапленнем
захаплен-нем	захапленнем
захап-ляліся	захапляліся
Захарааа	Захарава
заханеў	захацеў
за-ходніх	заходніх
заход-няй	заходняй
Заходнян	Заходняй
за-ходняя	заходняя
заход-няя	заходняя
эахоўвае	захоўвае
захоўва-ліся	захоўваліся
за-хоўваў	захоўваў
за-явіў	заявіў
эаявіў	заявіў
эбілі	збілі
зблі-жае	збліжае
эбожжа	збожжа
збо-ку	збоку
эбор	збор
эборнік	зборнік
збор-ніка	зборніка
эборніка	зборніка
збор-нікаў	зборнікаў
зборні-кі	зборнікі
эборніку	зборніку
збор-цы	зборцы
эборы	зборы
зважаю-чы	зважаючы
звана-га	званага
зван-не	званне
эванне	званне
эван-не	званне
зва-ныя	званыя
звер-ху	зверху
эвонкія	звонкія
звы-чайна	звычайна
звычанна	звычайна
эвычайна	звычайна
звы-чайнага	звычайнага
звычай-ная	звычайная
зяыш	звыш
эвыш	звыш
звя-зана	звязана
звяэаны	звязаны
звяэа-ны	звязаны
звя-заныя	звязаныя
звяр-нуліся	звярнуліся
звярну-ліся	звярнуліся
звяр-нуўся	звярнуўся
звяр-нуць	звярнуць
звяр-таемся	звяртаемся
звяртаешіа	звяртаецца
зга-дзіцца	згадзіцца
злабыткам	здабыткам
зда-валася	здавалася
здава-лася	здавалася
эдавалася	здавалася
здаенца	здаецца
здаецііа	здаецца
зда-ецца	здаецца
здаец-ца	здаецца
Здаешіа	Здаецца
здаешіа	здаецца
зда-ешіа	здаецца
эдалі	здалі
зда-роўя	здароўя
злароўя	здароўя
эдароўя	здароўя
зда-рылася	здарылася
здары-лася	здарылася
эдарылася	здарылася
эдзіўлены	здзіўлены
здзяй-сненне	здзяйсненне
здзяйс-ненняў	здзяйсненняў
здзяйснен-няў	здзяйсненняў
здоле-лі	здолелі
здо-леў	здолеў
злолеў	здолеў
эдолеў	здолеў
эдольнасці	здольнасці
здолыіы	здольны
здоль-ны	здольны
эдольны	здольны
эдольныя	здольныя
зды-мак	здымак
эдымак	здымак
здымну	здымку
эдымку	здымку
эдымну	здымку
з'езл	з'езд
з'еэд	з'езд
з'сзд	з'езд
з'ездл	з'езда
з'езла	з'езда
з'еэда	з'езда
з'сзда	з'езда
э'езда	з'езда
э'еэда	з'езда
з'езлу	з'езду
з'еэду	з'езду
э'езду	з'езду
э'еэду	з'езду
зем-лі	землі
эемлякі	землякі
эемлякоў	землякоў
земляроб-ства	земляробства
эерне	зерне
зза	з-за
зі-хацяць	зіхацяць
злеаа	злева
злі-ліся	зліліся
злу-чанымі	злучанымі
злуча-нымі	злучанымі
злу-чаных	злучаных
злуча-ныя	злучаныя
змагасцца	змагаецца
эмагаецца	змагаецца
зма-гайцеся	змагайцеся
змагай-цеся	змагайцеся
эмагаўся	змагаўся
зма-гацца	змагацца
эмагацца	змагацца
зма-гаюцца	змагаюцца
эмагаюцца	змагаюцца
эмаглі	змаглі
эмен	змен
эмена	змена
зме-ны	змены
эмены	змены
эмест	змест
эместам	зместам
змес-ту-	зместу
эместу	зместу
зме-шчана	змешчана
змешча-нае	змешчанае
эмешчаны	змешчаны
змітра-ка	змітрака
эмяніліся	змяніліся
энаёмства	знаёмства
знасмы	знаёмы
энаёмых	знаёмых
знайсні	знайсці
энайсні	знайсці
энайсці	знайсці
знай-шла	знайшла
энайшла	знайшла
энайшоў	знайшоў
знамяналь-ных	знамянальных
энаходжання	знаходжання
зна-ходзіліся	знаходзіліся
эна-ходзіўся	знаходзіўся
знаходзіц-ца	знаходзіцца
знаходзішіа	знаходзіцца
энаходзіцца	знаходзіцца
эна-ходэіцца	знаходзіцца
знаходзінь	знаходзіць
знахо-дзіць	знаходзіць
энаходзяцца	знаходзяцца
знаходзянь	знаходзяць
энаходзяць	знаходзяць
знач-на	значна
эначна	значна
эначнае	значнае
знач-най	значнай
эначную	значную
Значынь	Значыць
значынь	значыць
зна-чыць	значыць
зна-чьшь	значыць
эна-чыць	значыць
зна-чэнне	значэнне
значэн-не	значэнне
значэннс	значэнне
зна-чэння	значэння
значэн-ня	значэння
эначэння	значэння
энойдзе	знойдзе
энойдзеш	знойдзеш
эноў	зноў
эор	зор
эоры	зоры
зпад	з-пад
зра-білі	зрабілі
эрабілі	зрабілі
эра-білі	зрабілі
зра-біў	зрабіў
эрабіў	зрабіў
зрабіііь	зрабіць
зрабінь	зрабіць
зра-біць	зрабіць
эрабіць	зрабіць
зра-зумела	зразумела
зразу-мела	зразумела
зразумсла	зразумела
Зраэумела	Зразумела
зраэумеў	зразумеў
зразумень	зразумець
зра-зумець	зразумець
зраэумець	зразумець
эразумець	зразумець
эраэумець	зраэумець
эробіць	зробіць
зроб-лена	зроблена
зробле-на	зроблена
эроблена	зроблена
зробле-ны	зроблены
зроблс-ны	зроблены
эроблены	зроблены
зробле-ныя	зробленыя
зрэд-ку	зрэдку
зу-сім	зусім
эусім	зусім
ЗШЛ	ЗША
з'нвіўся	з'явіўся
з'явіц-ца	з'явіцца
з'явішіа	з'явіцца
зялё-нага	зялёнага
зя-лёным	зялёным
зялё-нымі	зялёнымі
эямель	зямель
эямельку	зямельку
зям-лі	зямлі
зямпі	зямлі
іямлі	зямлі
эямлі	зямлі
зям-лю	зямлю
эямлю	зямлю
Зямлюмаці	Зямлю-маці
зям-ля	зямля
эямля	зямля
эямляк	зямляк
зям-нога	зямнога
з'яўляеіша	з'яўляецца
з'яўляеп-ца	з'яўляецца
з'яўляецна	з'яўляецца
з'яў-ляецца	з'яўляецца
з'яўляец-ца	з'яўляецца
з'яўляешіа	з'яўляецца
з'яўлясцца	з'яўляецца
з'яўля-сцца	з'яўляецца
і'яўляецца	з'яўляецца
э'яўляецца	з'яўляецца
э'яў-ляецца	з'яўляецца
з'яў-ляліся	з'яўляліся
з'яў-ляюся	з'яўляюся
з'яўляюіша	з'яўляюцца
з'яўляюцна	з'яўляюцца
з'яў-ляюцца	з'яўляюцца
з'яўляюшіа	з'яўляюцца
э'яўля-юцца	з'яўляюцца
нскусство	искусство
1	і
Іввн	Іван
Івлн	Іван
Івян	Іван
Іяан	Іван
іва-на	івана
Івлна	Івана
Івяна	Івана
Івяня	Івана
Інана	Івана
іва-навіч	іванавіч
івана-віч	іванавіч
іванаў-на	іванаўна
ІВАНОУ	Іваноў
ігрань	іграць
ідзс	ідзе
ідэе	ідзе
ідунь	ідуць
ілэй	ідэй
ілэя	ідэя
ільі-ча	ільіча
ілюстраныі	ілюстрацыі
імё-нах	імёнах
імены	імёны
імклі-вы	імклівы
імк-ненне	імкненне
імкнен-не	імкненне
імкненнс	імкненне
імкнснне	імкненне
імкнсцца	імкнецца
імкнушіа	імкнуцца
імпе-рыялізму	імперыялізму
імперыя-лізму	імперыялізму
ім-перыялістаў	імперыялістаў
імпе-рыялістаў	імперыялістаў
імперы-ялістаў	імперыялістаў
імпе-рыялістычных	імперыялістычных
Індакітлй	Індакітай
інду-стрыі	індустрыі
інду-стрыялізацыя	індустрыялізацыя
індустры-яльную	індустрыяльную
ін-дыі	індыі
інжы-нер	інжынер
ін-жынера	інжынера
ін-жынерам	інжынерам
інжыне-рам	інжынерам
інжы-нерамі	інжынерамі
інжы-нераў	інжынераў
інжы-неры	інжынеры
іні-цыятыва	ініцыятыва
ініныятыве	ініцыятыве
ініцыя-тыве	ініцыятыве
ініцыя-тыву	ініцыятыву
ініцыяты-вы	ініцыятывы
інстру-мент	інструмент
інсты-тут	інстытут
ім-стытута	інстытута
ін-стытута	інстытута
інсты-тута	інстытута
інстыту-та	інстытута
ін-стытуты	інстытуты
ін-стытуне	інстытуце
ін-стытуце	інстытуце
інсты-туце	інстытуце
інта-нацый	інтанацый
інта-рэсаў	інтарэсаў
інтарэ-сы	інтарэсы
інтэлігенныі	інтэлігенцыі
інтэлі-генцыі	інтэлігенцыі
інтэрвен-таў	інтэрвентаў
ін-тэрнатах	інтэрнатах
інтэрнацыяналь-най	інтэрнацыянальнай
ін-фармацыю	інфармацыю
інша-га	іншага
ін-шую	іншую
ін-шы	іншы
ін-шым	іншым
ін-шымі	іншымі
іншы-мі	іншымі
ііішых	іншых
ін-шых	іншых
ііішыя	іншыя
ін-шыя	іншыя
іры-на	ірына
іс-наванне	існаванне
іс-навання	існавання
існус	існуе
існі	ісці
1х	іх
іш-ла	ішла
ішля	ішла
квб	каб
кзб	каб
клб	каб
кяб	каб
кабі-нет	кабінет
кабіне-це	кабінеце
каб-рынца	кабрынца
кабрын-ца	кабрынца
ка-валачку	кавалачку
ка-го	каго
калраў	кадраў
клжл	кажа
кажунь	кажуць
ка-жуць	кажуць
ка-жучы	кажучы
ка-эані	казані
каэаў	казаў
каз-ку	казку
каланія-лізму	каланіялізму
ка-ланіялыіых	каланіяльных
ка-лачынскі	калачынскі
кал-гас	калгас
кал-гаса	калгаса
калгасв	калгаса
кал-гасв	калгаса
калгасл	калгаса
калгася	калгаса
калга-саў	калгасаў
кал-гасах	калгасах
калга-сах	калгасах
кал-гасе	калгасе
калга-се	калгасе
калгасс	калгасе
калга-сс	калгасе
калгясе	калгасе
калгас-нікам	калгаснікам
калгас-нікаў	калгаснікаў
кал-гаснікі	калгаснікі
калгас-нікі	калгаснікі
кялгаснікі	калгаснікі
калгас-ніцы	калгасніцы
квл-гвсным	калгасным
кал-гасных	калгасных
калгас-ных	калгасных
калгясных-	калгасных
квлгвсных	калгасных
капегія	калегія
калек-тываў	калектываў
калекты-ваў	калектываў
калсктываў	калектываў
калектыау	калектыву
ка-лектыву	калектыву
калсктыву	калектыву
ка-лектывы	калектывы
калсктывы	калектывы
калекгыў	калектыў
ка-лектыў	калектыў
калек-тыў	калектыў
калсктыў	калектыў
ка-лсктыў	калектыў
кллектыў	калектыў
кялектыў	калектыў
ка-лі	калі
квлі	калі
кзлі	калі
кллі	калі
кэлі	калі
кялі	калі
каліні-на	калініна
калінін-града	калінінграда
калісьні	калісьці
ка-лісьці	калісьці
калісь-ці	калісьці
ка-лоны	калоны
калн	каля
ка-ля	каля
квля	каля
клля	каля
кяля	каля
каля-ровай	каляровай
камандзі-рам	камандзірам
камбіна-та	камбіната
камелыя	камедыя
ка-менем	каменем
каменаломнях	каменяломнях
камісары-ят	камісарыят
камісарыя-та	камісарыята
камі-сію	камісію
ка-мітэт	камітэт
кампазі-тар	кампазітар
кам-пазітара	кампазітара
кампа-зітара	кампазітара
кам-паэітара	кампазітара
кам-пазітарам	кампазітарам
кампазіта-рам	кампазітарам
кампа-зітараў	кампазітараў
кампазіта-раў	кампазітараў
кампаэітараў	кампазітараў
камназітары	кампазітары
кампаэіцыяй	кампазіцыяй
кам-самол	камсамол
кам-самольскай	камсамольскай
кам-самольскі	камсамольскі
кам-самольскія	камсамольскія
камса-молыіаў	камсамольцаў
камсамоль-цаў	камсамольцаў
камсамольны	камсамольцы
квмсвмольцы	камсамольцы
ка-мунізм	камунізм
каму-нізм	камунізм
камуніэм	камунізм
ка-мунізма	камунізма
каму-нізма	камунізма
камуніз-ма	камунізма
камунізмв	камунізма
камуніэма	камунізма
ка-муніэма	камунізма
квмуніэмв	камунізма
ка-муніст	камуніст
ка-муніста	камуніста
каму-ністам	камуністам
камуні-стаў	камуністаў
каму-ністычнага	камуністычнага
камуні-стычнага	камуністычнага
камуністыч-нага	камуністычнага
камуністычнагв	камуністычнага
камуні-стычнае	камуністычнае
Камумістычнай	Камуністычнай
ка-муністычнай	камуністычнай
каму-ністычнай	камуністычнай
камуні-стычнай	камуністычнай
камуніс-тычнай	камуністычнай
камуністыч-най	камуністычнай
камуністычнан	камуністычнай
Камуністычнвй	Камуністычнай
камуністычнлй	камуністычнай
камуністычняй	камуністычнай
камупістычнай	камуністычнай
Квмуністычнвй	Камуністычнай
кямуністыч-най	камуністычнай
муністычнай	камуністычнай
ка-муністычная	камуністычная
камуністыч-ная	камуністычная
ка-муністычных	камуністычных
камуністыч-ныя	камуністычныя
камяненкая	камянецкая
ка-напы	канапы
кан-веера	канвеера
кан-дыдатуры	кандыдатуры
канен	канец
кансц	канец
кан-крэтнай	канкрэтнай
кансерва-торыі	кансерваторыі
канстан-цін	канстанцін
кан-структараў	канструктараў
канст-руктараў	канструктараў
кан-тату	кантату
канферэн-цыі	канферэнцыі
канфсрэнцыі	канферэнцыі
клч-ферэнцыі	канферэнцыі
кан-ферэнцыю	канферэнцыю
кан-ферэнцыя	канферэнцыя
камфлікт	канфлікт
канфлік-таў	канфліктаў
канф-лікту	канфлікту
канфлік-ту	канфлікту
кан-флікты	канфлікты
кан-цы	канцы
каннэрт	канцэрт
кан-нэрт	канцэрт
канцзрт	канцэрт
кан-цэрт	канцэрт
каннэрта	канцэрта
кан-цэрта	канцэрта
каннэртамі	канцэртамі
каннэртаў	канцэртаў
канцэр-таў	канцэртаў
квнцэртаў	канцэртаў
кан-цэртная	канцэртная
капіталіэму	капіталізму
ка-піталістаў	капіталістаў
капі-талістычнага	капіталістычнага
капіталі-стычнай	капіталістычнай
капіта-лістычных	капіталістычных
капіталі-стычных	капіталістычных
капі-талістычныя	капіталістычныя
капіталі-стычныя	капіталістычныя
капыльска-га	капыльскага
квпэлы	капэлы
капя-люш	капялюш
ка-рабель	карабель
карабельспадарожнік	карабель-спадарожнік
караб-лёў	караблёў
ка-раблі	караблі
ка-рабля	карабля
караб-ля	карабля
карабляспадарожніка	карабля-спадарожніка
ка-раблях	караблях
ка-раюць	караюць
ка-роткай	кароткай
карот-кі	кароткі
каротніх	кароткіх
ка-роў	кароў
кар-ту	карту
кар-цін	карцін
карніне	карціне
кар-ціны	карціны
карыс-ную	карысную
ка-рыстаецца	карыстаецца
кары-стаецца	карыстаецца
карыс-таецца	карыстаецца
карыстаец-ца	карыстаецца
карыстаешіа	карыстаецца
ка-рыстаюцца	карыстаюцца
карыс-таюцца	карыстаюцца
клрысць	карысць
ка-рэйскай	карэйскай
ка-рэйскую	карэйскую
ка-рэліцкага	карэліцкага
кагманаўта	касманаўта
касманаў-та	касманаўта
касманаў-там	касманаўтам
касманаў-таў	касманаўтаў
касманау-ту	касманаўту
касманаў-ту	касманаўту
кагмічнага	касмічнага
ка-смічнага	касмічнага
кас-мічнага	касмічнага
касмічна-га	касмічнага
кас-мічнай	касмічнай
касміч-ная	касмічная
кас-мічную	касмічную
касміч-ны	касмічны
кас-мічным	касмічным
касміч-ным	касмічным
кас-мічных	касмічных
касміч-ных	касмічных
кастрыч-нік	кастрычнік
кастрыч-ніка	кастрычніка
ка-стрычніцкага	кастрычніцкага
кастрыч-ніцкай	кастрычніцкай
кастрычніц-кай	кастрычніцкай
Кастрычніцкан	Кастрычніцкай
каст-рычніцкую	кастрычніцкую
Касгусь	Кастусь
кас-тусь	кастусь
касцю-маў	касцюмаў
каш-курэвіч	кашкурэвіч
каш-тоўныя	каштоўныя
кяштоўныя	каштоўныя
квад-ратных	квадратных
квар-тале	квартале
квсткі	кветкі
квеце-ні	квецені
кене-дзі	кенедзі
кіёс-кі	кіёскі
кілагврцаў	кілагарцаў
кІлагерцаўЬ	кілагерцаў
кілагра-маў	кілаграмаў
кі-ламетраў	кіламетраў
кіламет-ры	кіламетры
кіна-калры	кінакадры
кінакал-ры	кінакадры
кінарэ-жысёр	кінарэжысёр
кіннсеткі	кінасеткі
кіна-студыі	кінастудыі
кінас-тудыі	кінастудыі
кіна-тэатры	кінатэатры
кі-нафільм	кінафільм
кінафіль-маў	кінафільмаў
кінафіль-мы	кінафільмы
кі-но	кіно
кіра-ваць	кіраваць
кіраў-ніка	кіраўніка
кіраўнінтва	кіраўніцтва
кіраўніцтаа	кіраўніцтва
кіраў-ніцтва	кіраўніцтва
кіраў-ніцтвам	кіраўніцтвам
кіраўніцт-вам	кіраўніцтвам
кіраўніцтвлм	кіраўніцтвам
кісла-водск	кіславодск
кла-са	класа
класі-каў	класікаў
кло-патаў	клопатаў
клопа-ту	клопату
кло-паты	клопаты
клопа-ты	клопаты
клу-ба	клуба
клубв	клуба
клубл	клуба
клу-баў	клубаў
клубвў	клубаў
клубнвй	клубнай
клуб-ных	клубных
нлуб-ных	клубных
кіііг	кніг
кнігв	кніга
кііігі	кнігі
ннігі	кнігі
кмігу	кнігу
кніж-ная	кніжная
кніэе	кнізе
кож-нага	кожнага
кожнагв	кожнага
кожнагз	кожнага
кожнлга	кожнага
кожнан	кожнай
кожнвй	кожнай
кож-нвй	кожнай
кожнлй	кожнай
кожняй	кожнай
кож-ная	кожная
кож-ную	кожную
кожііы	кожны
кожнм	кожны
ко-жны	кожны
кож-ны	кожны
кожньі	кожны
кожпы	кожны
кожііым	кожным
кожмым	кожным
кож-ным	кожным
ко-ласа	коласа
колькасні	колькасці
колькаснь	колькасць
коль-касць	колькасць
коль-кі	колькі
Коммуннст	Коммунист
ком-плексную	комплексную
кон-курсаў	конкурсаў
кон-курсе	конкурсе
кон-курсу	конкурсу
контр-удара	контрудара
кор-пуса	корпуса
кос-мас	космас
космлс	космас
носмас	космас
космасі	космасе
косма-сс	космасе
кос-масу	космасу
косма-су	космасу
космасу—гэта	космасу - гэта
КГІСС	КПСС
КІІСС	КПСС
краінм	краіам
краіп	краін
нраін	краін
краінв	краіна
краі-намі	краінамі
краі-нах	краінах
кра-іне	краіне
краінс	краіне
крвіне	краіне
краімы	краіны
краі-ны	краіны
крвй	край
кра-півы	крапівы
крапі-вы	крапівы
крага-віка	красавіка
красавікв	красавіка
нрасавіка	красавіка
нрасавіна	красавіна
кро-кам	крокам
кро-каў	крокаў
кро-ку	кроку
крык-нуў	крыкнуў
крыніны	крыніцы
крыты-ка	крытыка
крытыкв	крытыка
крытыкя	крытыка
крыты-каваў	крытыкаваў
крытыны	крытыцы
кры-ху	крыху
кры-чыць	крычыць
крэ-дытах	крэдытах
крэпасні	крэпасці
крэ-пасці	крэпасці
крэпаснь	крэпасць
ку-ба	куба
куба-метраў	кубаметраў
Кубннскага	Кубанскага
ку-бе	кубе
ку-бу	кубу
ку-бы	кубы
кулы	куды
кузняцо-ва	кузняцова
куэьма	кузьма
кузьмі-ча	кузьміча
куйбы-шава	куйбышава
куку-рузныя	кукурузныя
кукуруэу	кукурузу
кукуруэы	кукурузы
культурм	культура
куль-турай	культурай
культур-ным	культурным
куль-турных	культурных
кудьтуры	культуры
куль-гуры	культуры
куль-туры	культуры
культу-ры	культуры
культуры—32054	культуры
культурьі	культуры
купьтуры	культуры
нультуры	культуры
купалаў-цаў	купалаўцаў
ку-палу	купалу
Кулалы	Купалы
Куналы	Купалы
купа-лы	купалы
Купялы	Купалы
ку-рортаў	курортаў
ку-рорце	курорце
кур-са	курса
кут-ку	кутку
лаба-раторыі	лабараторыі
лабара-торыі	лабараторыі
ла-бараторыя	лабараторыя
ла-геры	лагеры
лагсры	лагеры
лагі-шына	лагішына
лагі-шыне	лагішыне
лагой-скага	лагойскага
ла-гун	лагун
Лдзін	Лазін
ла-мы	ламы
ла-ска	ласка
ла-скава	ласкава
латннскнй	латинский
лацін-скай	лацінскай
Лсанід	Леанід
ледэь	ледзь
лекныі	лекцыі
лек-цый	лекцый
лек-цыю	лекцыю
ле-нін	ленін
Лвніна	Леніна
ле-міна	леніна
ле-ніна	леніна
лені-на	леніна
ле-яіна	леніна
Лсіііна	Леніна
лсніна	леніна
лс-ніна	леніна
ле-ніне	леніне
ЕНІНІЗМ	ленінізм
лені-нізма	ленінізма
ленін-скага	ленінскага
ленінска-га	ленінскага
Лснінскага	Ленінскага
ле-нінскай	ленінскай
ленін-скім	ленінскім
ле-нінскіх	ленінскіх
ленін-скіх	ленінскіх
ле-ніным	леніным
лспш	лепш
леп-шае	лепшае
леп-шая	лепшая
леп-шы	лепшы
лспшы	лепшы
леп-шым	лепшым
леп-шымі	лепшымі
леп-шых	лепшых
лспшых	лепшых
леп-шыя	лепшыя
лспшыя	лепшыя
лес-віца	лесвіца
лста	лета
ле-там	летам
ле-тась	летась
лет-ні	летні
лётчы-ка	лётчыка
лётчыкакасманаўта	лётчыка-касманаўта
Лнтература	Литература
л1	лі
ліб-рэта	лібрэта
лінка-вец	лінкавец
ліпсня	ліпеня
лі-повы	ліповы
лі-рызмам	лірызмам
літаралыіа	літаральна
IТАРАТУРА	літаратура
ітаратура	літаратура
Літарагура	літаратура
лі-таратура	літаратура
літа-ратура	літаратура
літара-тура	літаратура
літа-ратурай	літаратурай
літа-ратурнага	літаратурнага
літара-турнага	літаратурнага
літаратур-нае	літаратурнае
літаратурнас	літаратурнае
літара-турных	літаратурных
літаратур-ныя	літаратурныя
лі-таратуру	літаратуру
літарагуры	літаратуры
літаратурм	літаратуры
лі-таратуры	літаратуры
літа-ратуры	літаратуры
літара-туры	літаратуры
літарату-ры	літаратуры
літаратуры—32204	літаратуры
літарвтуры	літаратуры
літарзтуры	літаратуры
літарлтуры	літаратуры
літаря-туры	літаратуры
літврвтуры	літаратуры
літлратуры	літаратуры
лі-тяратуры	літаратуры
лі-тоўскай	літоўскай
лі-тоўскім	літоўскім
лі-чылыіік	лічыльнік
лічыц-ца	лічыцца
лічынь	лічыць
лю-бая	любая
лю-бімых	любімых
лю-біў	любіў
любінь	любіць
лю-біць	любіць
лю-бой	любой
лю-боўю	любоўю
любянь	любяць
людаей	людзей
людзеіі	людзей
лю-дзей	людзей
людзен	людзей
людзсй	людзей
людэей	людзей
лю-дэей	людзей
люлзей	людзей
лю-лзей	людзей
люлэей	людзей
пюдзей	людзей
іюдзі	людзі
лю-дзі	людзі
людэі	людзі
люлзі	людзі
людзь-мі	людзьмі
людэьмі	людзьмі
людэям	людзям
лю-дзях	людзях
Люлміла	Людміла
люд-на	людна
Лявоіі	Лявон
лявоні-ха	лявоніха
ляг-лі	ляглі
ляс-ная	лясная
ляс-ных	лясных
ля-цець	ляцець
Мабынь	Мабыць
мабынь	мабыць
млга	мага
магаэін	магазін
магаэіна	магазіна
магаэінах	магазінах
ма-газіне	магазіне
мага-зіны	магазіны
магі-лёўскага	магілёўскага
магілёў-шчыны	магілёўшчыны
ма-гілу	магілу
ма-гілы	магілы
ма-гістралі	магістралі
магі-стралі	магістралі
магіст-ралі	магістралі
мягістралі	магістралі
маг-лі	маглі
мяглі	маглі
магутнасні	магутнасці
ма-гутнасці	магутнасці
ма-гутнасць	магутнасць
магут-нымі	магутнымі
магут-ных	магутных
мягут-ных	магутных
маг-чыма	магчыма
магчымасней	магчымасцей
магчы-масцей	магчымасцей
магчымасні	магчымасці
маг-чымасці	магчымасці
магчымаснь	магчымасць
маг-чымасць	магчымасць
магчы-масць	магчымасць
маей	маёй
мвёй	маёй
маё-рам	маёрам
МЛЗы	МАЗы
май-стра	майстра
май-строў	майстроў
мвйстроў	майстроў
млйстроў	майстроў
май-стры	майстры
майстзрства	майстэрства
майстэрстаа	майстэрства
май-стэрства	майстэрства
майстэр-ства	майстэрства
млйстэрства	майстэрства
ма-каёнка	макаёнка
малл	мала
малалая	маладая
маладзечанска-га	маладзечанскага
ма-ладога	маладога
мала-дога	маладога
маладо-га	маладога
малалога	маладога
маладон	маладой
малалой	маладой
мала-дому	маладому
ма-ладосць	маладосць
мала-ды	малады
малалы	малады
ма-лалы	малады
ма-ладым	маладым
мала-дым	маладым
ма-ладых	маладых
мала-дых	маладых
малалых	маладых
мвлвдых	маладых
млладых	маладых
мала-дыя	маладыя
малалыя	маладыя
ма-лака	малака
мала-ка	малака
малакя	малака
ма-лаком	малаком
маленстаа	маленства
ма-ленькай	маленькай
ма-ленькая	маленькая
малень-кая	маленькая
малень-кім	маленькім
малень-кіх	маленькіх
ма-ленькую	маленькую
малень-кую	маленькую
Малюнвк	малюнак
малюн-ках	малюнках
малюн-кі	малюнкі
маляўні-чыя	маляўнічыя
ман-гольскай	мангольскай
ма-неры	манеры
мансры	манеры
ма-ралі	маралі
ма-ральныя	маральныя
ма-раць	мараць
мар-кай	маркай
марксізмаленінізма	марксізма-ленінізма
марксісцкаленінскай	марксісцка-ленінскай
мар-фа	марфа
марціно-віч	марціновіч
ма-ры	мары
ма-рыйскай	марыйскай
марык-са	марыкса
ма-рылі	марылі
Л\арыя	Марыя
Мармя	Марыя
ма-рыя	марыя
маса-вых	масавых
ма-скве	маскве
маскві-чоў	масквічоў
маск-ву	маскву
асквы	масквы
ма-сквы	масквы
маск-вы	масквы
мас-так	мастак
маствк	мастак
млстак	мастак
мястак	мастак
ыастак	мастак
ма-стака	мастака
маста-ка	мастака
млстака	мастака
ма-стакі	мастакі
маствкі	мастакі
мястакі	мастакі
ма-стакоў	мастакоў
маста-коў	мастакоў
маствкоў	мастакоў
мастлкоў	мастакоў
млстакоў	мастакоў
мястакоў	мастакоў
мастакоўграфікаў	мастакоў-графікаў
ма-стаку	мастаку
мастанкага	мастацкага
ма-стацкага	мастацкага
мастанкае	мастацкае
мас-тацкае	мастацкае
мастаіікай	мастацкай
мастанкай	мастацкай
мастапкай	мастацкай
ма-стацкай	мастацкай
мас-тацкай	мастацкай
мастац-кай	мастацкай
мастацкан	мастацкай
мастацквй	мастацкай
мастацмай	мастацкай
мастацнай	мастацкай
мвствцквй	мастацкай
мастанкая	мастацкая
мастац-кал	мастацкая
ма-стацкая	мастацкая
мастац-кая	мастацкая
мастанкі	мастацкі
мастац-кі	мастацкі
мастанкім	мастацкім
маствцкім	мастацкім
мастанкіх	мастацкіх
ма-стацкіх	мастацкіх
мастац-кіх	мастацкіх
маствцкіх	мастацкіх
млстацкіх	мастацкіх
мастанкія	мастацкія
ма-стацкія	мастацкія
мастац-кія	мастацкія
масгацтва	мастацтва
мастаіітва	мастацтва
мастантва	мастацтва
мас-тантва	мастацтва
мастаптва	мастацтва
мастацтаа	мастацтва
мастац-таа	мастацтва
ма-стацтва	мастацтва
мас-тацтва	мастацтва
мастац-тва	мастацтва
мастацт-ва	мастацтва
мастацтва*	мастацтва
мастацтвв	мастацтва
мастацтвя	мастацтва
мастацтпа	мастацтва
мастацтяа	мастацтва
маствцтва	мастацтва
маствцтвв	мастацтва
мастлцтва	мастацтва
мзстацтва	мастацтва
мястацтва	мастацтва
мастантвам	мастацтвам
мастацтвг	мастацтве
мастац-тве	мастацтве
мастацтвс	мастацтве
мастацтпе	мастацтве
матэрыя-лам	матэрыялам
ма-тэрыялаў	матэрыялаў
ма-тэрыяле	матэрыяле
ма-тэрыялу	матэрыялу
матзрьія-лы	матэрыялы
матэрыя-лы	матэрыялы
мвтэрыялы	матэрыялы
матэрыяль-най	матэрыяльнай
матэрыяльнатэхнічнай	матэрыяльна-тэхнічнай
матэ-рыяльную	матэрыяльную
матэ-рыяльныя	матэрыяльныя
матэры-яльныя	матэрыяльныя
ма-ці	маці
млці	маці
ма-шын	машын
ма-шына	машына
ма-шынабудавання	машынабудавання
машы-ну	машыну
маюііь	маюць
маюнь	маюць
ма-юць	маюць
мвюць	маюць
мвя	мая
маякоўска-га	маякоўскага
медалем	медалём
мсжамі	межамі
ме-жах	межах
мсжах	межах
ме-лі	мелі
мело-дыя	мелодыя
мера-прыемства	мерапрыемства
ме-рапрыемствы	мерапрыемствы
мерапрысмствы	мерапрыемствы
ме-рах	мерах
меркавань	меркаваць
мерка-ваць	меркаваць
ме-ры	меры
мсры	меры
месна	месца
меспа	месца
ме-сца	месца
мес-ца	месца
месцв	месца
месцл	месца
месця	месца
мссца	месца
мес-цам	месцам
месцанара-джэнняў	месцанараджэнняў
мес-цах	месцах
мсс-цах	месцах
меспы	месцы
мес-цы	месцы
мс-сяц	месяц
месяны	месяцы
ме-сяцы	месяцы
ме-тадам	метадам
мета-дам	метадам
мстадаў	метадаў
мета-лаў	металаў
мета-ліст	металіст
метрл	метра
мстра	метра
мвтраў	метраў
метрлў	метраў
мстраў	метраў
мст-раў	метраў
ме-ханізацыі	механізацыі
механіэмаў	механізмаў
Л\нннстерства	Министерства
Ммннстерства	Министерства
Мнннстврства	Министерства
Мнннстерсгва	Министерства
мнннстерства	министерства
Мнннстерствв	Министерства
Мнннстсрства	Министерства
м1	мі
міжна-родным	міжнародным
міжна-родных	міжнародных
мі-калай	мікалай
міка-лай	мікалай
мі-кіта	мікіта
мікі-та	мікіта
мі-кіту	мікіту
Міколя	Мікола
Мікопа	Мікола
міль-ёнаў	мільёнаў
мільё-наў	мільёнаў
міль-ёны	мільёны
мільё-ны	мільёны
міль-ярды	мільярды
мі-ма	міма
мініст-ра	міністра
ініст-раў	міністраў
міні-страў	міністраў
мініст-раў	міністраў
міні-стэрства	міністэрства
мініс-тэрства	міністэрства
міністэр-ства	міністэрства
Міністэрствв	Міністэрства
Міністэрствл	Міністэрства
Л\інск	Мінск
Міііск	Мінск
Мінек	Мінск
мннск	мінск
ліін-ска	мінска
мін-ска	мінска
Мінскя	Мінска
МІнскага	Мінскага
мін-скага	мінскага
Мінскагв	Мінскага
Мінскан	Мінскай
Мінсквй	Мінскай
МінскІ	Мінскі
мін-ску	мінску
міму-лага	мінулага
мі-нулага	мінулага
міну-лага	мінулага
мінулагя	мінулага
мінулас	мінулае
мі-нулым	мінулым
міну-лым	мінулым
міпулым	мінулым
мі-нут	мінут
мі-нуту	мінуту
мі-нуты	мінуты
міну-ты	мінуты
міран-коў	міранкоў
мірна-га	мірнага
мір-нае	мірнае
мі-ровіч	міровіч
МІронавым	Міронавым
мі-ру	міру
МІхаІл	Міхаіл
мі-хаіл	міхаіл
міхай-лавіч	міхайлавіч
мі-хась	міхась
міцке-віч	міцкевіч
міц-кевіча	міцкевіча
Міцксвіча	Міцкевіча
мнс	мне
мно-га	многа
многя	многа
мпога	многа
мно-гае	многае
многас	многае
многана-цыянальнай	многанацыянальнай
мііогіх	многіх
мно-гіх	многіх
Ліногія	многія
мно-гія	многія
мо-вах	мовах
моае	мове
мо-ве	мове
мовс	мове
моау	мову
мо-ву	мову
моаы	мовы
могунь	могуць
могупь	могуць
мо-гуць	могуць
мвдных	модных
мо-жа	можа
можв	можа
можл	можа
Можя	Можа
можя	можа
мо-жя	можа
мо-жна	можна
мож-на	можна
можнв	можна
можня	можна
моладдэю	моладдзю
молалдзю	моладдзю
мола-дзі	моладзі
моладэі	моладзі
молалзі	моладзі
молвдзі	моладзі
мо-ладзь	моладзь
моладэь	моладзь
молвдэь	моладзь
мо-лвдэь	моладзь
моллдзь	моладзь
момлнт	момант
моман-ту	моманту
манстра	монстра
мо-ра	мора
моц-на	моцна
моцня	моцна
моцна-га	моцнага
моц-ная	моцная
муж-насці	мужнасці
мужнаснь	мужнасць
муж-насць	мужнасць
музсі	музеі
муэеі	музеі
муэей	музей
муэею	музею
муэея	музея
му-зеях	музеях
музе-ях	музеях
Муэыка	Музыка
муэыкантаў	музыкантаў
музмкі	музыкі
му-зыкі	музыкі
муэыкі	музыкі
муэы-кі	музыкі
муэыку	музыку
музыны	музыцы
му-зыцы	музыцы
муэыцы	музыцы
музыч-нага	музычнага
муэычнага	музычнага
му-зычнай	музычнай
муэычнай	музычнай
му-эычнай	музычнай
му-зычную	музычную
муэычную	музычную
му-зычны	музычны
муэычны	музычны
муэычным	музычным
муэычнымі	музычнымі
муэычных	музычных
муэыч-ных	музычных
му-зычныя	музычныя
муэычныя	музычныя
му-раваны	мураваны
Мусінь	Мусіць
мусінь	мусіць
му-сіць	мусіць
мя-жу	мяжу
мяк-ка	мякка
мннс	мяне
мя-не	мяне
мянс	мяне
мя-нс	мяне
мя-са	мяса
мяс-ціны	мясціны
мясцо-вай	мясцовай
на-адварот	наадварот
наадва-рот	наадварот
на-быў	набыў
навагруд-скага	навагрудскага
навагрудчы-не	навагрудчыне
наваколь-нага	навакольнага
нава-рыча	наварыча
нааат	нават
наваг	нават
на-ват	нават
навзт	нават
навят	нават
наяат	нават
нлват	нават
навсдваюць	наведваюць
нааук	навук
на-вук	навук
нлвук	навук
нааукі	навукі
на-вукі	навукі
наву-кі	навукі
нввукі	навукі
нлвукі	навукі
навуповатзхнічная	навукова-тэхнічная
навуковатэхнічны	навукова-тэхнічны
на-вуковыя	навуковыя
на-вуку	навуку
на-вум	навум
на-вумовіч	навумовіч
нааучальных	навучальных
наву-чалыіых	навучальных
на-вучальных	навучальных
наву-чальных	навучальных
навучан-ня	навучання
нагляд-ную	наглядную
няд	над
над-звычай	надзвычай
надзвы-чай	надзвычай
надзвычан	надзвычай
нядзвычай	надзвычай
надзён-ны	надзённы
на-дзею	надзею
на-дэею	надзею
на-друкаваны	надрукаваны
надрука-ваны	надрукаваны
на-зад	назад
назал	назад
наэад	назад
назаўсё-ды	назаўсёды
на-эаўсёды	назаўсёды
наз-вай	назвай
наэваў	назваў
названь	назваць
назы-вае	называе
называс	называе
называеіша	называецца
найболын	найбольш
найболып	найбольш
най-больш	найбольш
няйбольш	найбольш
найвялік-шай	найвялікшай
найвялік-шая	найвялікшая
найвялік-шых	найвялікшых
найшы-рэйшыя	найшырэйшыя
накірлваны	накіраваны
накіроў-ваюцца	накіроўваюцца
накіроўва-юць	накіроўваюць
на-ладзіла	наладзіла
наладзінь	наладзіць
налгаса	налгала
належань	належаць
належынь	належыць
на-лежыць	належыць
нале-жыць	належыць
нвм	нам
нама-галася	намагалася
на-меснік	намеснік
намсснік	намеснік
наме-чаны	намечаны
на-мі	намі
нлмі	намі
на-перад	наперад
напсрад	наперад
напі-салі	напісалі
на-пісанні	напісанні
напісан-ня	напісання
напі-саны	напісаны
напіса-ныя	напісаныя
на-пісаць	напісаць
напі-саць	напісаць
на-прамку	напрамку
напружа-най	напружанай
на-прыклад	напрыклад
напры-клад	напрыклад
напрык-лад	напрыклад
напрыклал	напрыклад
няпрыклад	напрыклад
напэў-на	напэўна
напярэ-дадні	напярэдадні
нараджаец-ца	нараджаецца
на-ралжалася	нараджалася
нараджалі-ся	нараджаліся
нараджзння	нараджэння
нара-джзння	нараджэння
нара-джэііня	нараджэння
на-раджэння	нараджэння
нара-джэння	нараджэння
нараджэн-ня	нараджэння
на-радзе	нарадзе
на-радзілася	нарадзілася
нарадзі-лася	нарадзілася
на-радзіўся	нарадзіўся
наралу	нараду
наралы	нарады
на-род	народ
нарол	народ
нврод	народ
на-рода	народа
наро-да	народа
народл	народа
нарола	народа
на-рола	народа
наро-ла	народа
нарпда	народа
нвродв	народа
нв-родв	народа
нвро-дв	народа
на-родам	народам
наро-дам	народам
наролам	народам
нвродвм	народам
на-родамі	народамі
на-родаў	народаў
наро-даў	народаў
наролаў	народаў
нвродаў	народаў
пародаў	народаў
на-родзе	народзе
народзс	народзе
на-роднага	народнага
народна-га	народнага
народнагз	народнага
народнагл	народнага
народнвга	народнага
народпага	народнага
наролнага	народнага
на-роднай	народнай
народ-най	народнай
народнан	народнай
Народнан	Народнай
народнвй	народнай
народнлй	народнай
наролнай	народнай
наролная	народная
народ-ную	народную
на-родны	народны
народ-ны	народны
наролны	народны
нлродны	народны
наролным	народным
на-родных	народных
наролных	народных
нлродных	народных
на-родныя	народныя
народ-ныя	народныя
наролныя	народныя
на-роды	народы
наро-ды	народы
на-рыс	нарыс
нврыс	нарыс
нв-рыс	нарыс
нары-саў	нарысаў
нарьі-саў	нарысаў
на-рысе	нарысе
нарых-тоўках	нарыхтоўках
на-рэшце	нарэшце
нарэш-це	нарэшце
нарэшцс	нарэшце
нвс	нас
насе-віч	насевіч
населыііцтва	насельніцтва
насельніцтаа	насельніцтва
на-сельніцтва	насельніцтва
насельніц-тва	насельніцтва
нассльніцтва	насельніцтва
на-стаўнік	настаўнік
настаў-ніка	настаўніка
на-стаўнікамі	настаўнікамі
на-стаўнікаў	настаўнікаў
настаў-нікаў	настаўнікаў
настаўні-каў	настаўнікаў
на-стаўнікі	настаўнікі
настаў-нікі	настаўнікі
на-стойліва	настойліва
настой-ліва	настойліва
наступі-ла	наступіла
на-ступіць	наступіць
наступ-нага	наступнага
на-ступны	наступны
нас-тупным	наступным
насупрань	насупраць
на-супраць	насупраць
на-сустрач	насустрач
нвсустрач	насустрач
на-татак	нататак
на-таша	наташа
ната-ша	наташа
натх-нёнай	натхнёнай
нат-хніла	натхніла
на-тхняе	натхняе
натх-няе	натхняе
наў-рад	наўрад
наўрал	наўрад
на-ціску	націску
на-цый	нацый
нацыяна-лістаў	нацыяналістаў
наныянальнага	нацыянальнага
нацыя-нальнага	нацыянальнага
нацыяналь-нага	нацыянальнага
нацыяналыіай	нацыянальнай
на-цыянальнай	нацыянальнай
нацыяналь-най	нацыянальнай
нацыя-нальнасцей	нацыянальнасцей
нацыяналь-ную	нацыянальную
на-цыянальным	нацыянальным
нацыяналь-ных	нацыянальных
нацыя-налыіыя	нацыянальныя
нацюр-мортаў	нацюрмортаў
на-чальнік	начальнік
на-ша	наша
нашв	наша
нвшв	наша
няша	наша
ня-ша	наша
на-шага	нашага
наша-га	нашага
нашагв	нашага
нашяга	нашага
нвшага	нашага
нзшага	нашага
пашага	нашага
наніай	нашай
нашаіі	нашай
на-шай	нашай
нашан	нашай
нашвй	нашай
нашзй	нашай
нашлй	нашай
нашяй	нашай
нвшай	нашай
нвшвй	нашай
нзшай	нашай
нлшай	нашай
няшай	нашай
ня-шай	нашай
на-шу	нашу
на-шчадкаў	нашчадкаў
нашм	нашы
нашн	нашы
на-шы	нашы
нвшы	нашы
нлшы	нашы
няшы	нашы
на-шым	нашым
няшым	нашым
ня-шым	нашым
на-шымі	нашымі
на-шых	нашых
нвшых	нашых
на-шэсце	нашэсце
ііе	не
Нс	Не
нс	не
не-абходна	неабходна
нсабходна	неабходна
неабход-нае	неабходнае
неаб-ходную	неабходную
неабход-ным	неабходным
неад-наразова	неаднаразова
неадоль-ную	неадольную
не-ба	неба
нсба	неба
нс-ба	неба
небс	небе
неве-рагодна	неверагодна
невера-годна	неверагодна
нсвядома	невядома
невядо-мых	невядомых
нсвялікі	невялікі
нсвялікія	невялікія
нсда-лёка	недалёка
не-далёкім	недалёкім
неластаткова	недастаткова
нелахоп	недахоп
не-дахопаў	недахопаў
недахоны	недахопы
незабыў-ныя	незабыўныя
незалеж-на	незалежна
неза-лежнасці	незалежнасці
не-залежнасць	незалежнасць
неза-лежнасць	незалежнасць
незаслу-жана	незаслужана
незвычай-ная	незвычайная
незвычай-ную	незвычайную
неэвычайную	незвычайную
не-звычайны	незвычайны
незра-зумелыя	незразумелыя
ней-кая	нейкая
ней-кі	нейкі
ненкую	нейкую
нейтра-літэту	нейтралітэту
нейтраль-ная	нейтральная
не-калі	некалі
не-калькі	некалькі
некаль-кі	некалькі
не-квлькі	некалькі
некллькі	некалькі
некялькі	некалькі
нскалькі	некалькі
некаль-кіх	некалькіх
не-каму	некаму
некато-ры	некаторы
не-каторых	некаторых
некато-рых	некаторых
нематорых	некаторых
нскаторых	некаторых
некато-рыя	некаторыя
нскаторыя	некаторыя
нс-каторыя	некаторыя
нскато-рыя	некаторыя
нелыа	нельга
нель-га	нельга
Нсльга	нельга
нсльга	нельга
не-магчыма	немагчыма
немаг-чыма	немагчыма
нсмагчыма	немагчыма
немны	немцы
непа-рушнае	непарушнае
непа-рушная	непарушная
нспасрэдна	непасрэдна
нспасрэдных	непасрэдных
непаў-торная	непаўторная
неўзабавс	неўзабаве
не-шта	нешта
нсяк	неяк
Нсяк	Неяк
нібм	нібы
ні-быта	нібыта
ніка-вых	нікавых
нікіфа-раў	нікіфараў
іііколі	ніколі
ні-колі	ніколі
ні-колькі	ніколькі
іііх-то	ніхто
ні-чога	нічога
нічо-га	нічога
ні-якіх	ніякіх
новабу-доўляў	новабудоўляў
ноаага	новага
но-вага	новага
нова-га	новага
новагв	новага
новагя	новага
новвгв	новага
новяга	новага
нонага	новага
нопага	новага
но-вае	новае
новас	новае
но-вай	новай
нован	новай
новвй	новай
нопая	новая
но-вікава	новікава
ноаую	новую
но-вую	новую
но-вы	новы
новы-мі	новымі
нопымі	новымі
ноаых	новых
но-вых	новых
ноаыя	новыя
но-выя	новыя
нопыя	новыя
нояыя	новыя
носінь	носіць
носянь	носяць
нумвры	нумары
ня-гледзячы	нягледзячы
ня-даўна	нядаўна
нядаў-на	нядаўна
нядаў-ня	нядаўна
Нядлўна	Нядаўна
нялаўна	нядаўна
нядзвлях	нядзелях
нядзслях	нядзелях
нядэелях	нядзелях
ня-лёгка	нялёгка
ня-ма	няма
нямв	няма
нямз	няма
нямл	няма
нямя	няма
няма-ла	нямала
нямяла	нямала
нямецкафашысцкімі	нямецка-фашысцкімі
нямецкафашысцкіх	нямецка-фашысцкіх
ня-мецкія	нямецкія
Нямігя	Няміга
ня-мігі	нямігі
ня-рэдка	нярэдка
нярэд-ка	нярэдка
Ннсвіжскага	Нясвіжскага
няспын-нага	няспыннага
ня-спынных	няспынных
няста-чы	нястачы
ня-ўхільна	няўхільна
ня-хай	няхай
Няхвй	Няхай
опер-ны	оперны
опер-ных	оперных
оперы*	оперы
опсры	оперы
оргвн	орган
ордзна	ордэна
пабліэу	паблізу
пабу-давалі	пабудавалі
па-будавана	пабудавана
пабудаааны	пабудаваны
пабу-даваны	пабудаваны
пабу-лаваных	пабудаваных
пвбудвваў	пабудаваў
пабы-вала	пабывала
пабы-валі	пабывалі
па-бываў	пабываў
пабызаў	пабываў
па-быў	пабыў
па-вагай	павагай
паважа-ныя	паважаныя
паведа-мілі	паведамілі
паведа-міў	паведаміў
павсдаміў	паведаміў
па-ведамленне	паведамленне
паве-дамленне	паведамленне
паведам-ляе	паведамляе
па-вел	павел
павільё-ны	павільёны
ііавінен	павінен
паві-нен	павінен
плвінен	павінен
пааінна	павінна
павін-на	павінна
папінна	павінна
павін-ны	павінны
папінны	павінны
пввінны	павінны
плвінны	павінны
пявінны	павінны
пявін-ны	павінны
паводзі-намі	паводзінамі
паволыіа	павольна
па-высіць	павысіць
павышэн-ні	павышэнні
па-вялічылася	павялічылася
павялічы-ліся	павялічыліся
павялі-чыць	павялічыць
паглядзень	паглядзець
па-глядзець	паглядзець
пагля-дзі	паглядзі
на-грозы	пагрозы
па-грозы	пагрозы
па-гутарыць	пагутарыць
пвд	пад
пзд	пад
пададзе-ны	пададзены
падар-ваць	падарваць
падарож-жа	падарожжа
паларожжа	падарожжа
падарож-жаў	падарожжаў
па-дарожжах	падарожжах
пада-рожжах	падарожжах
пада-рунак	падарунак
паларункі	падарункі
пада-рыць	падарыць
на-даць	падаць
пад-бегла	падбегла
пад-вяргаўся	падвяргаўся
падзсі	падзеі
па-дзей	падзей
пядзей	падзей
падзяка-ваць	падзякаваць
падзя-ку	падзяку
пад-копы	падкопы
падкрэслівас	падкрэслівае
пад-крэсліваў	падкрэсліваў
падкрэс-ліў	падкрэсліў
пвдкрэсліў	падкрэсліў
палняўся	падняўся
палобны	падобны
палобныя	падобныя
падпіс-ных	падпісных
падрабяэна	падрабязна
пад-рабязным	падрабязным
падрых-таваны	падрыхтаваны
падрыхтананы	падрыхтаваны
падрых-таваць	падрыхтаваць
пад-рыхтоўцы	падрыхтоўцы
падрыхтоў-цы	падрыхтоўцы
палрыхтоўцы	падрыхтоўцы
палставы	падставы
паду-май	падумай
падумань	падумаць
паду-маць	падумаць
палумаць	падумаць
паеэдка	паездка
паезлкі	паездкі
па-ехаць	паехаць
пажаланні	пажаданні
паза-штатны	пазаштатны
пазіныі	пазіцыі
па-зіцыі	пазіцыі
паэіцый	пазіцый
па-зіцыях	пазіцыях
пазнаё-міліся	пазнаёміліся
па-энаёміліся	пазнаёміліся
паэнаёміўся	пазнаёміўся
пазнаё-міцца	пазнаёміцца
паэнаёміцца	пазнаёміцца
ГІазней	пазней
па-зней	пазней
пайсні	пайсці
пай-сці	пайсці
пай-шла	пайшла
паншла	пайшла
пай-шоў	пайшоў
па-казана	паказана
пака-заў	паказаў
паказань	паказаць
па-казаць	паказаць
пакаэаць	паказаць
паказвас	паказвае
па-казвас	паказвае
па-казваецца	паказваецца
паказвань	паказваць
па-казу	паказу
пака-ленні	пакаленні
пакален-ні	пакаленні
па-калення	пакалення
пакален-ня	пакалення
пакамуністычнаму	па-камуністычнаму
па-карыцеля	пакарыцеля
пакарыце-лям	пакарыцелям
пакарэн-ня	пакарэння
пакі-далі	пакідалі
пакі-нуў	пакінуў
пакінунь	пакінуць
па-кінуць	пакінуць
пакі-нуць	пакінуць
па-клёп	паклёп
накоі	пакоі
па-кой	пакой
па-кончыць	пакончыць
пакон-чыць	пакончыць
па-куль	пакуль
пякуль	пакуль
пала-цам	палацам
па-лепшыць	палепшыць
палеп-шыць	палепшыць
па-лет	палет
палет	палёт
па-лёт	палёт
пвлёт	палёт
па-лётах	палётах
палё-тах	палётах
палбту	палёту
палету	палёту
па-лёту	палёту
палё-ту	палёту
палеў	палёў
палеце	палёце
паліграфіч-ным	паліграфічным
паліты-ка	палітыка
па-літыкі	палітыкі
палі-тыкі	палітыкі
палітыч-най	палітычнай
палітыч-ную	палітычную
палітыч-ны	палітычны
пвлітычныя	палітычныя
палі-цыю	паліцыю
палот-нішчах	палотнішчах
па-лотны	палотны
палымя-нага	палымянага
пальчэў-скага	пальчэўскага
па-любіць	палюбіць
паля-цела	паляцела
паля-цеў	паляцеў
па-мешчыка	памешчыка
па-між	паміж
памы-лак	памылак
памя-тае	памятае
па-мятаю	памятаю
памянь	памяць
пвмяць	памяць
памяшканнс	памяшканне
па-нерыў	панерыў
паняц-ці	паняцці
Папершае	Па-першае
папсры	паперы
папоў-ніўся	папоўніўся
па-прасіў	папрасіў
ІІапулярнасць	папулярнасць
ла-рад	парад
паралак	парадак
парад-ку	парадку
паралку	парадку
пара-ды	парады
паране-ны	паранены
парансны	паранены
параў-нанні	параўнанні
параўнан-ні	параўнанні
пара-шутыстаў	парашутыстаў
парка-вую	паркавую
пар-най	парнай
партрзты	партрэты
парт-рэты	партрэты
партрэ-ты	партрэты
партыэан	партызан
партызан-скага	партызанскага
пар-тызанскай	партызанскай
партызан-скай	партызанскай
нартызаны	партызаны
партыэаны	партызаны
лартыі	партыі
нартыі	партыі
паргыі	партыі
пар-тыі	партыі
пвртыі	партыі
пзртыі	партыі
плртыі	партыі
партыйнаарганізацыйнай	партыйна-арганізацыйнай
партыннага	партыйнага
пар-тыйнай	партыйнай
партый-най	партыйнай
пар-тыйная	партыйная
партый-ная	партыйная
партый-ных	партыйных
пар-тыя	партыя
пвртыя	партыя
пвр-тыя	партыя
пасадзінь	пасадзіць
па-сёлка	пасёлка
пасёл-ках	пасёлках
па-сёлку	пасёлку
пасла-лі	паслалі
па-слаць	паслаць
паслухай-це	паслухайце
гіасля	пасля
ласля	пасля
насля	пасля
па-сля	пасля
пас-ля	пасля
Пвсля	пасля
пзсля	пасля
плсля	пасля
Пясля	Пасля
пясля	пасля
пасля-ваенныя	пасляваенныя
ласпяхова	паспяхова
пас-пяхова	паспяхова
паспяхо-ва	паспяхова
пас-пяховага	паспяховага
паспяхо-вага	паспяховага
паставі-лі	паставілі
паставіпь	паставіць
паста-віць	паставіць
паста-ім	пастаім
пастаноў-шчык	пастаноўшчык
па-стаўлены	пастаўлены
пасту-паюць	паступаюць
паступінь	паступіць
пасту-піць	паступіць
пася-джэнне	пасяджэнне
пасялжэнні	пасяджэнні
пася-джэння	пасяджэння
патраба-вальнасць	патрабавальнасць
патраба-ванні	патрабаванні
патраба-ванням	патрабаванням
пат-рабаваць	патрабаваць
натрабуе	патрабуе
па-трабуе	патрабуе
патра-буе	патрабуе
патрабус	патрабуе
патрыя-тычная	патрыятычная
патрэ-бен	патрэбен
па-трзбна	патрэбна
патрэб-на	патрэбна
па-трэбны	патрэбны
натрэбы	патрэбы
паты-ліха	патыліха
паў-дзікай	паўдзікай
паў-натой	паўнатой
паў-тараць	паўтараць
паход-жання	паходжання
пача-ла	пачала
па-чалася	пачалася
пача-так	пачатак
пачат-ку	пачатку
па-чаў	пачаў
па-чаць	пачаць
пачнем	пачнём
па-чуў	пачуў
па-чуішё	пачуццё
па-чуццё	пачуццё
пачуццсм	пачуццем
пачуц-цяў	пачуццяў
пачушіяў	пачуццяў
па-чын	пачын
пачынас	пачынае
пачы-наецца	пачынаецца
пачынаец-ца	пачынаецца
пачынасцца	пачынаецца
пачынаюнь	пачынаюць
па-чынаючы	пачынаючы
пачы-наючы	пачынаючы
пачынаю-чы	пачынаючы
пачынаю-чых	пачынаючых
па-чэснай	пачэснай
пашто-вак	паштовак
па-шырыўся	пашырыўся
па-шырыць	пашырыць
паэ-зіі	паэзіі
паээіі	паэзіі
паэ-ма	паэма
пазмы	паэмы
наэт	паэт
пазт	паэт
Плэт	Паэт
пяэт	паэт
паэтл	паэта
па-этаў	паэтаў
паэ-таў	паэтаў
паэ-ты	паэты
плэты	паэты
паэ-тычных	паэтычных
пая-дынак	паядынак
педа-гагічнай	педагагічнай
пелагог	педагог
пенсія-нер	пенсіянер
пе-равагі	перавагі
пера-грузак	перагрузак
пе-рад	перад
перал	перад
первд	перад
перяд	перад
псрад	перад
перада-валі	перадавалі
пера-давікам	перадавікам
перадавіка-мі	перадавікамі
перадааі-коў	перадавікоў
пе-радавікоў	перадавікоў
перада-вікоў	перадавікоў
перада-вога	перадавога
первдввогв	перадавога
перв-дввогв	перадавога
первдв-вогв	перадавога
псрадавы	перадавы
пералавым	перадавым
пера-давых	перадавых
пералавых	перадавых
псрадавых	перадавых
пе-радавыя	перадавыя
пера-давыя	перадавыя
пе-радае	перадае
псрадаў	перадаў
перадань	перадаць
пе-радань	перадаць
пе-радаць	перадаць
пера-даць	перадаць
псрадаць	перадаць
пс-радача	перадача
пераехау	пераехаў
пе-раканальна	пераканальна
псраканальна	пераканальна
пера-канаўча	пераканаўча
Псраклад	Пераклад
пералес-кі	пералескі
нерамог	перамог
псрамог	перамог
пе-рамога	перамога
пера-мога	перамога
перамо-га	перамога
Псрамога	Перамога
перамо-гай	перамогай
лерлмогі	перамогі
пе-рамогі	перамогі
перамо-гі	перамогі
пера-могу	перамогу
пе-рамогуць	перамогуць
псра-можцы	пераможцы
нерамозе	перамозе
пера-нёс	перанёс
перапоў-нены	перапоўнены
перапыні-ла	перапыніла
пе-рапынку	перапынку
ператва-рыць	ператварыць
пера-тварэння	ператварэння
пераўзы-дзе	пераўзыдзе
пе-раўтварэнні	пераўтварэнні
пераходзінь	пераходзіць
псраходзіць	пераходзіць
пе-рашкаджае	перашкаджае
пера-шкаджае	перашкаджае
пера-шкаджаюць	перашкаджаюць
псрсанажаў	персанажаў
перспек-тыву	перспектыву
перспек-тывы	перспектывы
псрспектывы	перспектывы
псрш	перш
пер-шага	першага
перша-га	першага
першвгв	першага
псршага	першага
пер-шай	першай
першвй	першай
псршай	першай
пер-шамая	першамая
Першамвя	Першамая
пер-шаму	першаму
пер-шачарговыя	першачарговыя
пер-шая	першая
пер-шую	першую
псршую	першую
лершы	першы
пер-шы	першы
псршы	першы
лершым	першым
пер-шым	першым
псршым	першым
першы-мі	першымі
псршымі	першымі
псршых	першых
лершыя	першыя
нершыя	першыя
пер-шыя	першыя
псршыя	першыя
перы-яд	перыяд
псрыяд	перыяд
перыялу	перыяду
псрыяду	перыяду
п'сса	п'еса
н'есам	п'есам
п'е-се	п'есе
п'есс	п'есе
п'ссе	п'есе
песнн	песен
лесень	песень
пе-сень	песень
песснь	песень
песмі	песні
пес-мі	песні
пес-ні	песні
пссні	песні
пвсню	песню
пес-ню	песню
лесня	песня
пес-ня	песня
пссня	песня
песннх	песнях
пес-нях	песнях
п'ссу	п'есу
м'есы	п'есы
н'есы	п'есы
п'ссы	п'есы
псць	пець
Пннскнх	Пинских
пнсателей	писателей
піліпа-віч	піліпавіч
пілотамкасманаўтам	пілотам-касманаўтам
пілоткасманаўт	пілот-касманаўт
пі-лоту	пілоту
пін-скага	пінскага
пін-чанам	пінчанам
пісала-ся	пісалася
пі-салі	пісалі
пі-саў	пісаў
пісань	пісаць
пі-саць	пісаць
пісь-ме	пісьме
лісьменнік	пісьменнік
нісьменнік	пісьменнік
пісь-меннік	пісьменнік
пісь-мсннік	пісьменнік
пісь-менніка	пісьменніка
пісьменні-ка	пісьменніка
пісьменнікв	пісьменніка
пісьменнікл	пісьменніка
пісьменпіка	пісьменніка
пісьмепніка	пісьменніка
пісьмснніка	пісьменніка
пісьменніквмі	пісьменнікамі
лісьменнікаў	пісьменнікаў
пігьменнікаў	пісьменнікаў
пісьменнікау	пісьменнікаў
пісь-меннікаў	пісьменнікаў
пісьменні-каў	пісьменнікаў
пісьменніклў	пісьменнікаў
пісьмсннікаў	пісьменнікаў
пісьмсн-нікаў	пісьменнікаў
пісьмсшіікаў	пісьменнікаў
пісь-менніку	пісьменніку
пісьменніны	пісьменніцы
нісьмо	пісьмо
лісьмы	пісьмы
пісь-мы	пісьмы
пішя	піша
пішунь	пішуць
пі-шуць	пішуць
ііішы	пішы
піяне-ра	піянера
піяне-ры	піянеры
пладано-сіць	пладаносіць
нлан	план
пллн	план
нлана	плана
пла-на	плана
пла-намі	планамі
пла-не	плане
пла-нета	планета
пла-неты	планеты
плане-ты	планеты
пла-неце	планеце
пла-ны	планы
пле-нума	пленума
плену-ма	пленума
пло-шча	плошча
пло-шчаў	плошчаў
пло-шчах	плошчах
ллошчы	плошчы
пло-шчы	плошчы
пля-чыма	плячыма
плячы-ма	плячыма
побвч	побач
по-дзвіг	подзвіг
подэвіг	подзвіг
подэ-віг	подзвіг
ползвіг	подзвіг
подзнігам	подзвігам
по-дэвігі	подзвігі
по-дзвігу	подзвігу
подэві-гу	подзвігу
по-дых	подых
Поланкага	Полацкага
полацка-га	полацкага
полз-вігаў	ползвігаў
полы-мя	полымя
поль-скай	польскай
поль-шчы	польшчы
пом-нік	помнік
пом-ніка	помніка
пом-нікаў	помнікаў
пом-ніках	помніках
помнішіа	помніцца
по-спех	поспех
по-спсх	поспех
по-спехам	поспехам
поспе-хам	поспехам
поспехлм	поспехам
поспехвў	поспехаў
поспсхаў	поспехаў
пос-псхаў	поспехаў
лоспехах	поспехах
по-спехах	поспехах
поспе-хах	поспехах
по-спехі	поспехі
поспе-хі	поспехі
поспс-хі	поспехі
по-спеху	поспеху
поспе-ху	поспеху
поспсху	поспеху
по-ступ	поступ
по-тым	потым
поў-на	поўна
поў-нага	поўнага
поўна-га	поўнага
поў-нае	поўнае
поў-най	поўнай
поўнасню	поўнасцю
поў-насцю	поўнасцю
поў-нач	поўнач
поў-ным	поўным
пошу-каў	пошукаў
по-шукі	пошукі
прл	пра
пря	пра
прабле-ма	праблема
праблсма	праблема
праблсмах	праблемах
праб-лемы	праблемы
прабле-мы	праблемы
праблсмы	праблемы
праб-лсмы	праблемы
пра-ва	права
пра-вадыра	правадыра
правалыра	правадыра
пра-ведзен	праведзен
правесні	правесці
пра-вёў	правёў
пра-віла	правіла
правіль-на	правільна
правіль-най	правільнай
пра-вільны	правільны
правіль-ны	правільны
право-дзіцца	праводзіцца
праводзішіа	праводзіцца
праводзіпь	праводзіць
пра-водзіць	праводзіць
право-дзяцца	праводзяцца
праграмл	праграма
Праграмс	Праграме
праграмс	праграме
пра-граму	праграму
прагра-му	праграму
прагрлму	праграму
Праграчы	Праграмы
Прагрвмы	Праграмы
пра-грэс	прагрэс
прагрэсіў-нае	прагрэсіўнае
прагрэсіў-ным	прагрэсіўным
пра-грэсу	прагрэсу
прад-метаў	прадметаў
прадме-таў	прадметаў
праднрыемства	прадпрыемства
прадпрыемстаа	прадпрыемства
прад-прыемства	прадпрыемства
праднрыемстваў	прадпрыемстваў
пралпрыемстваў	прадпрыемстваў
прад-прыемствы	прадпрыемствы
пралпрыемствы	прадпрыемствы
прад-стаўлена	прадстаўлена
прадстаўленыя	прадстаўлення
прадстаў-лены	прадстаўлены
прадстаў-леных	прадстаўленых
прад-стаўнікоў	прадстаўнікоў
пралстаўнікоў	прадстаўнікоў
пра-дуктаў	прадуктаў
пра-дукты	прадукты
прадукныі	прадукцыі
прадук-ныі	прадукцыі
пра-дукцыі	прадукцыі
прадук-цыі	прадукцыі
прадукцыйнас-ці	прадукцыйнасці
прадукцый-насць	прадукцыйнасць
прадук-цыя	прадукцыя
прадэман-стравала	прадэманстравала
нраекта	праекта
праект-ных	праектных
праскце	праекце
првекце	праекце
Нраз	праз
нраз	праз
праэ	праз
Прдз	Праз
пряз	праз
прай-сці	прайсці
прай-шлі	прайшлі
праншлі	прайшлі
прайшоу	прайшоў
праншоў	прайшоў
пра-кладвае	пракладвае
прак-тыку	практыку
практыны	практыцы
прамысло-вай	прамысловай
нрамысловасці	прамысловасці
пра-мысловасці	прамысловасці
прамысло-васці	прамысловасці
прамысло-васць	прамысловасць
нрамысловых	прамысловых
прамысло-вых	прамысловых
пранік-лі	праніклі
пра-нікненне	пранікненне
пранік-нення	пранікнення
пранік-нуць	пранікнуць
прапаганлаваць	прапагандаваць
прапягянду	прапаганду
првпвгвнду	прапаганду
прапа-ганды	прапаганды
пра-панова	прапанова
прапано-ву	прапанову
прана-ноў	прапаноў
пра-рыў	прарыў
пра-сілі	прасілі
пра-славіў	праславіў
пра-слухалі	праслухалі
праспент	праспект
праспя-ваць	праспяваць
праста-це	прастаце
прастор-ны	прасторны
пра-стору	прастору
лрасторы	прасторы
прасто-ры	прасторы
пра-сякнута	прасякнута
пра-сякнуты	прасякнуты
праў-да	праўда
праўдв	праўда
Праўла	Праўда
праўла	праўда
праў-ла	праўда
прлўда	праўда
праў-дай	праўдай
праўдзі-ва	праўдзіва
праўлу	праўду
праўлы	праўды
праў-ленне	праўленне
првўленне	праўленне
првўлен-не	праўленне
правлення	праўлення
праулення	праўлення
праў-лення	праўлення
прафссар	прафесар
прафссій	прафесій
прлфесія	прафесія
прафе-сіянальных	прафесіянальных
прафссіянальных	прафесіянальных
нрафсаюзаў	прафсаюзаў
прафсаюэаў	прафсаюзаў
прахо-дзіў	праходзіў
праходзінь	праходзіць
праходзянь	праходзяць
пра-ходзяць	праходзяць
нраца	праца
прана	праца
праца-валі	працавалі
пранаваў	працаваў
працаааў	працаваў
пра-цаваў	працаваў
праца-ваў	працаваў
нрацаваць	працаваць
праііаваць	працаваць
пранаваць	працаваць
працаааць	працаваць
працавань	працаваць
праца-вань	працаваць
пра-цаваць	працаваць
праца-ваць	працаваць
працавзць	працаваць
праца-наць	працаваць
працвваць	працаваць
прана-дня	працадня
лрацай	працай
#ИМЯ?	працаўнікі
пра-цоўнага	працоўнага
працоў-нага	працоўнага
пра-цоўны	працоўны
пра-цоўным	працоўным
працоў-ным	працоўным
пра-цоўнымі	працоўнымі
првцоўнымі	працоўнымі
лрацоўных	працоўных
праноўных	працоўных
пра-цоўных	працоўных
працоў-ных	працоўных
працоўпых	працоўных
пра-цоўпых	працоўных
првцоўных	працоўных
прлцоўных	працоўных
працоў-ныя	працоўныя
пра-цу	працу
лрацуе	працуе
нрацуе	працуе
прануе	працуе
пра-цуе	працуе
працус	працуе
првцуе	працуе
прлцуе	працуе
пра-цую	працую
нрацуюць	працуюць
прануюць	працуюць
працуюііь	працуюць
працуюнь	працуюць
пра-цуюць	працуюць
працу-юць	працуюць
првцуюць	працуюць
нрацы	працы
нра-цы	працы
праііы	працы
праны	працы
пра-ны	працы
пра-пы	працы
пра-цы	працы
працьі	працы
пра-цьі	працы
првцы	працы
прзцы	працы
прлцы	працы
пряцы	працы
нрацэнта	працэнта
нрацэнтаў	працэнтаў
пранэнтаў	працэнтаў
пра-цэнтаў	працэнтаў
працэн-таў	працэнтаў
пра-цэс	працэс
пранэсу	працэсу
працэ-су	працэсу
праця-гам	працягам
нрацягвае	працягвае
працягвас	працягвае
працяг-валася	працягвалася
працягвала-ся	працягвалася
праЦгваюць	працягваюць
пра-цяглыя	працяглыя
нрацягу	працягу
пранягу	працягу
прлцягу	працягу
нрачытаў	прачытаў
пра-чытаў	прачытаў
пра-чытвў	прачытаў
праяў-ляе	праяўляе
пролаж	продаж
про-звішча	прозвішча
прозві-шча	прозвішча
проэвішча	прозвішча
прозві-шчах	прозвішчах
прозві-шчы	прозвішчы
про-зе	прозе
проэы	прозы
лроста	проста
нроста	проста
про-ста	проста
простл	проста
про-стага	простага
про-стай	простай
проста-му	простаму
прос-тую	простую
про-стых	простых
про-стыя	простыя
прось-ба	просьба
прось-бай	просьбай
нры	пры
прыбалты-цы	прыбалтыцы
пры-блізна	прыблізна
пры-быткі	прыбыткі
пры-ватнасці	прыватнасці
прыват-насці	прыватнасці
прывесні	прывесці
прывітан-не	прывітанне
прыво-дзіць	прыводзіць
пры-водэіць	прыводзіць
прыво-дзяшіа	прыводзяцца
прыву-чылі	прывучылі
прыга-жоспь	прыгажосць
прыгне-чання	прыгнечання
прыгняталь-нікаў	прыгнятальнікаў
прыгнятальні-каў	прыгнятальнікаў
нрыгожа	прыгожа
пры-гожага	прыгожага
пры-гожая	прыгожая
прыго-жая	прыгожая
пры-гожыя	прыгожыя
прылумаць	прыдумаць
Прысмна	Прыемна
прысмна	прыемна
прысмнай	прыемнай
прыём-нік	прыёмнік
прыём-ніка	прыёмніка
прыёмні-ка	прыёмніка
пры-ехала	прыехала
нрыехалі	прыехалі
пры-ехаў	прыехаў
прысхаў	прыехаў
пры-знана	прызнана
пры-знацца	прызнацца
прызнань	прызнаць
прыэнаць	прызнаць
пры-зямлення	прызямлення
прызям-лення	прызямлення
прыэямлення	прызямлення
прындзе	прыйдзе
прыншла	прыйшла
прыншлі	прыйшлі
#ИМЯ?	прыйшлі
нрыклад	прыклад
пры-клад	прыклад
пры-кладна	прыкладна
прыклална	прыкладна
прыкла-дуць	прыкладуць
прыклалы	прыклады
прык-метна	прыкметна
пры-мае	прымае
пры-маў	прымаў
прымань	прымаць
прыма-юць	прымаюць
пры-ме	прыме
пры-муць	прымуць
прыму-шае	прымушае
прынам-сі	прынамсі
прынссла	прынесла
прыносінь	прыносіць
прыно-сіць	прыносіць
прыно-сяць	прыносяць
прынныпы	прынцыпы
пры-няла	прыняла
пры-нялі	прынялі
прыпеу	прыпеў
пры-пеўкі	прыпеўкі
нрыроды	прыроды
пры-роды	прыроды
прыро-ды	прыроды
прыролы	прыроды
прысве-чан	прысвечан
прысвсчана	прысвечана
прысвеча-нае	прысвечанае
прысвсча-най	прысвечанай
прысвечвны	прысвечаны
прысвсчаны	прысвечаны
прысвеча-ным	прысвечаным
прысвсчаных	прысвечаных
пры-свечаныя	прысвечаныя
прысве-чаныя	прысвечаныя
прысвеча-ныя	прысвечаныя
пры-своена	прысвоена
пры-свяціў	прысвяціў
пры-стойны	прыстойны
пры-сутнасці	прысутнасці
прысутні-чаюць	прысутнічаюць
прысутніча-юць	прысутнічаюць
пры-хільна	прыхільна
пры-ходам	прыходам
прыходэіць	прыходзіць
пры-чым	прычым
прыязджаюнь	прыязджаюць
прыязлжаюць	прыязджаюць
прыяэджаюць	прыязджаюць
прыя-рытэт	прыярытэт
Прээідыум	Прэзідыум
прэ-зідыума	прэзідыума
прэзідыу-ма	прэзідыума
прэзілыума	прэзідыума
Прээідыума	Прэзідыума
прэзідэн-ту	прэзідэнту
прэм'сру	прэм'еру
прэм'сры	прэм'еры
прэ-міях	прэміях
прэсканферзнцыі	прэс-канферэнцыі
прэ-стыж	прэстыж
пунк-там	пунктам
пу-цёўках	пуцёўках
пу-цёўкі	пуцёўкі
Пушкінв	Пушкіна
пы-ла	пыла
пыр-ко	пырко
пы-таемся	пытаемся
пы-танне	пытанне
пытаннс	пытанне
нытанні	пытанні
пы-танні	пытанні
пытвнні	пытанні
пытлнні	пытанні
пытан-няў	пытанняў
пятніну	пятніцу
пят-роўна	пятроўна
пят-рук	пятрук
пянь	пяць
пяпь	пяць
ра-біў	рабіў
рабінь	рабіць
ра-біць	рабіць
ра-бот	работ
ра-бота	работа
рабо-та	работа
работл	работа
рлбота	работа
ра-ботай	работай
рабо-тай	работай
ра-ботніка	работніка
работні-кам	работнікам
ра-ботнікаў	работнікаў
работ-нікаў	работнікаў
работніклў	работнікаў
ра-ботнінаў	работнікаў
рвботнікаў	работнікаў
рвботні-каў	работнікаў
ра-ботнікі	работнікі
работні-кі	работнікі
рвботнікі	работнікі
рвботні-кі	работнікі
ра-боту	работу
рабо-ту	работу
рвботу	работу
рв-боту	работу
рабогы	работы
ра-боты	работы
рабо-ты	работы
рлботы	работы
рабоне	рабоце
рабоцс	рабоце
ра-боцс	рабоце
рзбоце	рабоце
ра-бочага	рабочага
рабо-чага	рабочага
рабоча-га	рабочага
ра-бочы	рабочы
рабо-чы	рабочы
рабо-чым	рабочым
рабо-чымі	рабочымі
рабочы-мі	рабочымі
ра-бочых	рабочых
рабо-чых	рабочых
рвбочых	рабочых
ра-бочыя	рабочыя
рабо-чыя	рабочыя
рлбочыя	рабочыя
ра-гу	рагу
ра-гулі	рагулі
рагу-лі	рагулі
ра-ласна	радасна
ра-даснае	радаснае
радас-нае	радаснае
радас-нымі	радаснымі
ра-дасныя	радасныя
ра-дасць	радасць
радвсць	радасць
ра-дасцю	радасцю
радзі-ма	радзіма
радэіма	радзіма
#ИМЯ?	радзіма
ра-дзіме	радзіме
Радзімс	Радзіме
радэіме	радзіме
ра-дзіму	радзіму
радзі-му	радзіму
радэіму	радзіму
І'адзімы	радзімы
ра-дзімы	радзімы
Радзімы*	Радзімы
радэімы	радзімы
Рвдзімы	Радзімы
ра-дуемся	радуемся
ра-ды	рады
ра-дыё	радыё
радыс	радыё
ралыё	радыё
рвдыё	радыё
ра-дыёактыўны	радыёактыўны
радыёактыў-ных	радыёактыўных
радыя-тары	радыятары
ра-ён	раён
рлён	раён
раена	раёна
раёнл	раёна
раёня	раёна
раёпа	раёна
рвёнв	раёна
рлё-на	раёна
раё-наў	раёнаў
раё-нах	раёнах
раене	раёне
рлёне	раёне
раён-нага	раённага
расннага	раённага
раённяй	раённай
раён-ная	раённая
рлённых	раённых
раэ	раз
разабраіша	разабрацца
разабрашіа	разабрацца
ра-зам	разам
разлм	разам
разям	разам
раэам	разам
ра-эам	разам
раэ-бураную	разбураную
разві-ваецца	развіваецца
раз-віваліся	развіваліся
развівац-ца	развівацца
развівань	развіваць
раз-віваюцца	развіваюцца
разві-ваючы	развіваючы
развіцце	развіцце
раз-віццё	развіццё
развішіё	развіццё
раз-віцці	развіцці
развіц-ці	развіцці
развішіі	развіцці
развішію	развіццю
развіішя	развіцця
развінця	развіцця
раз-віцця	развіцця
развішія	развіцця
раэ-гарнуліся	разгарнуліся
раз-глядам	разглядам
раэгрому	разгрому
раздзсл	раздзел
раэзбраенне	раззбраенне
раз-мова	размова
раз-мову	размову
размо-ву	размову
раз-мовы	размовы
раэмовы	размовы
размя-шчэнне	размяшчэнне
размя-шчэння	размяшчэння
разна-стайнай	разнастайнай
разнастай-насці	разнастайнасці
разннстайнасці	разнастайнасці
раіннстнйны	разнастайны
раэнастайны	разнастайны
разнастай-ных	разнастайных
разняволе-ным	разняволеным
ра-зоў	разоў
раэоў	разоў
раэумее	разумее
разумсць	разумець
разумеюнь	разумеюць
раэумеюць	разумеюць
ра-зумна	разумна
ра-зумны	разумны
ра-зы	разы
раэы	разы
разыйшліся	разыйшліся
разый-шліся	разыйшліся
ранкома	райкома
рай-прамкамбіната	райпрамкамбіната
ра-кету	ракету
ра-кеты	ракеты
рама-на	рамана
рлмана	рамана
ра-манаву	раманаву
рамлне	рамане
раман-таваць	рамантаваць
ра-мантычная	рамантычная
ра-маны	раманы
ра-монт	рамонт
ра-мяства	рамяства
раня	рана
ра-нак	ранак
ра-ней	раней
ра-нсй	раней
рвней	раней
ра-ны	раны
рап-там	раптам
РасІІ	Расіі
ра-сіі	расіі
Рлсіі	Расіі
ра-сія	расія
рас-кажа	раскажа
раскаэ	расказ
расказа-лі	расказалі
расказань	расказаць
рас-казаць	расказаць
раска-заць	расказаць
раскаэаць	расказаць
рас-казвае	расказвае
расказвзе	расказвае
раскаэвае	расказвае
раскаэ-вае	расказвае
раскдзвае	расказвае
расказваец-ца	расказваецца
расказ-вала	расказвала
рас-казваць	расказваць
расказ-ваць	расказваць
расказнаць	расказваць
расказваюнь	расказваюць
рас-казваюць	расказваюць
раско-пак	раскопак
раскры-вае	раскрывае
раскры-ваць	раскрываць
рас-крыла	раскрыла
рас-крыты	раскрыты
раскрынь	раскрыць
распараджэн-не	распараджэнне
распаўсюджван-ню	распаўсюджванню
растлума-чыў	растлумачыў
растлума-чыць	растлумачыць
рас-туць	растуць
ра-сце	расце
расцс	расце
расн	расы
рацыяналіза-тараў	рацыяналізатараў
ра-шучага	рашучага
рашу-чым	рашучым
ра-шэннем	рашэннем
рашэн-нем	рашэннем
ра-шэнняў	рашэнняў
рашэн-няў	рашэнняў
робішіа	робіцца
робінь	робіць
ро-біць	робіць
робянь	робяць
робя-чы	робячы
родна-га	роднага
род-най	роднай
роднан	роднай
роднвй	роднай
роднлй	роднай
ролнай	роднай
ролную	родную
род-ны	родны
ролны	родны
род-ным	родным
род-ныя	родныя
ро-за	роза
роз-думу	роздуму
роз-нымі	рознымі
роэнымі	рознымі
розііых	розных
роз-ііых	розных
роз-ных	розных
роэных	розных
роз-ныя	розныя
роэныя	розныя
ро-эум	розум
ро-зуму	розуму
ро-эуму	розуму
роэу-му	розуму
ро-лю	ролю
ро-сце	росце
ру-бель	рубель
ру-бінштэйна	рубінштэйна
руо-лёў	рублёў
рубры-кай	рубрыкай
руж-жом	ружжом
ру-жы	ружы
ру-ка	рука
рукямі	рукамі
ру-кі	рукі
ру-ку	руку
ру-сака	русака
рус-кага	рускага
рус-кае	рускае
рус-кай	рускай
рус-кіх	рускіх
рус-кую	рускую
ру-ху	руху
рыб-кавец	рыбкавец
Рмгор	Рыгор
ры-гор	рыгор
рыго-ра	рыгора
рых-туюцца	рыхтуюцца
рыхтуюццв	рыхтуюцца
рыхтуюнь	рыхтуюць
рых-туюць	рыхтуюць
рэа-лізму	рэалізму
рэаліэму	рэалізму
рэвалюныі	рэвалюцыі
рэвллюцыі	рэвалюцыі
рэва-люцыйнага	рэвалюцыйнага
рэвалюцый-най	рэвалюцыйнай
рэ-валюцыйным	рэвалюцыйным
рэвалюцый-ных	рэвалюцыйных
рэва-люцыю	рэвалюцыю
рэ-гулярна	рэгулярна
рэгу-лярна	рэгулярна
рэгуляр-на	рэгулярна
рэ-дактар	рэдактар
рэлактар	рэдактар
рэдак-тара	рэдактара
рздакцыі	рэдакцыі
рэдакныі	рэдакцыі
рэдак-цыі	рэдакцыі
рэдлкцыі	рэдакцыі
рэлакцыі	рэдакцыі
Рэдакныйная	рэдакцыйная
РЭДАКЦЬШНАЯ	рэдакцыйная
рэдакныю	рэдакцыю
рэдак-цыю	рэдакцыю
рэдакныя	рэдакцыя
рэжысвр	рэжысёр
рэ-жысёр	рэжысёр
рэ-жысср	рэжысёр
рэ-жысёра	рэжысёра
рэжысё-раў	рэжысёраў
рэ-жысёры	рэжысёры
рэжысё-ры	рэжысёры
рэзсрвы	рэзервы
рэнорд	рэкорд
рзпертар	рэпертуар
рэпер-туар	рэпертуар
рэпсртуар	рэпертуар
рэ-пертуару	рэпертуару
рэпер-туары	рэпертуары
рэпсртуары	рэпертуары
рэ-петьшыі	рэпетыцыі
рэс-публік	рэспублік
рэспуб-лік	рэспублік
рэспуб-ліканскай	рэспубліканскай
рэспублікан-скай	рэспубліканскай
рэспублі-канская	рэспубліканская
рзспублікі	рэспублікі
рэслублікі	рэспублікі
рэс-публікі	рэспублікі
рэспуб-лікі	рэспублікі
рэспублі-кі	рэспублікі
рэспубліні	рэспублікі
рэспубліЦі	рэспублікі
рзспубліцы	рэспубліцы
рэслубліцы	рэспубліцы
рэснубліцы	рэспубліцы
рэспубліны	рэспубліцы
рэс-публіцы	рэспубліцы
рэспуб-ліцы	рэспубліцы
рэспублі-цы	рэспубліцы
рэнэнзіі	рэцэнзіі
рэчаіснасні	рэчаіснасці
рэчаіснаснь	рэчаіснасць
рэчаіс-насць	рэчаіснасць
са-баленка	сабаленка
са-бе	сабе
сабс	сабе
спбе	сабе
са-бой	сабой
са-бою	сабою
сабра-лася	сабралася
сабралі-ся	сабраліся
са-ве	саве
са-вет	савет
савст	савет
Сааета	Савета
са-вета	савета
саве-та	савета
савста	савета
га-вецкага	савецкага
Сааецкага	Савецкага
сааецкага	савецкага
савенкага	савецкага
савепкага	савецкага
са-вецкага	савецкага
савец-кага	савецкага
савецка-га	савецкага
савецкагв	савецкага
савецкагл	савецкага
савец-кяга	савецкага
САВЕЦНІАГА	савецкага
Савоцкага	Савецкага
савоц-кага	савецкага
савснкага	савецкага
савсн-кага	савецкага
савсцкага	савецкага
савсцка-га	савецкага
са-нецкага	савецкага
Сввецкага	Савецкага
сввецкага	савецкага
сввецквгв	савецкага
сааецкай	савецкай
савенкай	савецкай
Савепкай	Савецкай
са-вецкай	савецкай
савец-кай	савецкай
Савецкан	Савецкай
савсцкай	савецкай
сансцкай	савецкай
сапецкай	савецкай
са-вецкаму	савецкаму
савец-каму	савецкаму
Савенкая	Савецкая
савен-кая	савецкая
са-вецкая	савецкая
савец-кая	савецкая
савсцкая	савецкая
сааецкі	савецкі
савеіікі	савецкі
савенкі	савецкі
са-венкі	савецкі
са-вецкі	савецкі
савец-кі	савецкі
савсцкі	савецкі
савенкім	савецкім
савен-кім	савецкім
савец-кім	савецкім
савсн-кім	савецкім
Савсцкім	Савецкім
савсцкім	савецкім
савец-кімі	савецкімі
савецкі-мі	савецкімі
сааецкіх	савецкіх
савенкіх	савецкіх
са-венкіх	савецкіх
савен-кіх	савецкіх
савепкіх	савецкіх
са-вецкіх	савецкіх
савец-кіх	савецкіх
савсцкіх	савецкіх
сапецкіх	савецкіх
саяецкіх	савецкіх
са-венкія	савецкія
савепкія	савецкія
са-вецкія	савецкія
савец-кія	савецкія
савсцкія	савецкія
са-вецкую	савецкую
савсцкую	савецкую
са-яецкую	савецкую
садзе-янне	садзеянне
садруж-насць	садружнасць
са-ду	саду
са-ды	сады
са-ковіч	саковіч
са-кратар	сакратар
сак-ратар	сакратар
сакра-тар	сакратар
са-кун	сакун
Свкун	Сакун
сала-вей	салавей
саламона-ва	саламонава
сал-дат	салдат
сал-даты	салдаты
свле	сале
саліс-ты	салісты
са-люту	салюту
свм	сам
слм	сам
свмв	сама
са-мааддана	самааддана
сама-аддана	самааддана
са-мадзейнага	самадзейнага
са-мадзейнасці	самадзейнасці
самадзей-насці	самадзейнасці
самадзейнас-ці	самадзейнасці
самалзейна-сці	самадзейнасці
самвдзейнвсці	самадзейнасці
самэдзей-насці	самадзейнасці
свмвдэейнвсці	самадзейнасці
самвдзейнвсць	самадзейнасць
самадзейнас-цю	самадзейнасцю
самадзей-ным	самадзейным
сачадзейных	самадзейных
сама-дзейныя	самадзейныя
самадзей-ныя	самадзейныя
са-мае	самае
сама-звалаў	самазвалаў
са-май	самай
сямяй	самай
са-малёт	самалёт
сама-лёт	самалёт
сама-стойнай	самастойнай
самастой-ным	самастойным
са-мая	самая
са-мі	самі
слмі	самі
свмы	самы
слмы	самы
са-мым	самым
са-мымі	самымі
са-мых	самых
свмых	самых
са-мыя	самыя
св-мыя	самыя
санато-рыях	санаторыях
слнтымет-раў	сантыметраў
сапраў-днага	сапраўднага
сапраўд-нага	сапраўднага
сапраўлнага	сапраўднага
сапраўд-най	сапраўднай
сапраўд-ная	сапраўдная
сапраў-дны	сапраўдны
сапраўд-ны	сапраўдны
са-праўдным	сапраўдным
салраўды	сапраўды
санраўды	сапраўды
са-праўды	сапраўды
сапраўлы	сапраўды
свпраўды	сапраўды
сяпраўды	сапраўды
саракагод-дзя	саракагоддзя
сар-дэчнае	сардэчнае
саў-гасаў	саўгасаў
саў-гасах	саўгасах
саўгвсвх	саўгасах
саўга-се	саўгасе
саф-ронава	сафронава
саныялізм	сацыялізм
са-цыялізм	сацыялізм
са-цыялізма	сацыялізма
сацыя-лізма	сацыялізма
сацыяліз-ма	сацыялізма
сацыяліэма	сацыялізма
саныялістычнага	сацыялістычнага
сацыядстічнага	сацыялістычнага
са-цыялістычнага	сацыялістычнага
сацыялі-стычнага	сацыялістычнага
сацыялістыч-нага	сацыялістычнага
сацыялістычна-га	сацыялістычнага
саныялістычнай	сацыялістычнай
са-цыялістычнай	сацыялістычнай
сацыяліс-тычнай	сацыялістычнай
сацыялістыч-най	сацыялістычнай
Сацыялістычнан	Сацыялістычнай
сацыялі-стычная	сацыялістычная
сацыялістыч-ная	сацыялістычная
са-цыялістычную	сацыялістычную
сацыя-лістычную	сацыялістычную
са-цыялістычны	сацыялістычны
са-цыялістычным	сацыялістычным
сапыялістычных	сацыялістычных
са-цыялістычных	сацыялістычных
сацыя-лістычных	сацыялістычных
сацыялі-стычных	сацыялістычных
сацыяліс-тычных	сацыялістычных
сацыялістыч-ных	сацыялістычных
са-цыялістычныя	сацыялістычныя
сацыялі-стычныя	сацыялістычныя
са-чылі	сачылі
саюэ	саюз
Слюз	Саюз
Саюаа	Саюза
С'аюза	Саюза
са-юза	саюза
саю-за	саюза
Саюіа	Саюза
саюэа	саюза
Саюэл	Саюза
сяюза	саюза
саю-зам	саюзам
саю-заў	саюзаў
Саюэе	Саюзе
саюэных	саюзных
свабод-на	свабодна
свабод-ным	свабодным
сва-боду	свабоду
свабо-ду	свабоду
сва-боды	свабоды
сваболы	свабоды
саае	свае
свас	свае
свзе	свае
сяае	свае
свлё	сваё
снаё	сваё
еваёй	сваёй
сааёй	сваёй
саа-ёй	сваёй
свабй	сваёй
сваёіі	сваёй
сва-ёй	сваёй
сваён	сваёй
сваЛй	сваёй
свасй	сваёй
свзёй	сваёй
свлёй	сваёй
свяёй	сваёй
снаёй	сваёй
спаёй	сваёй
сяаёй	сваёй
сваёйтворчасці	сваёй творчасці
сааім	сваім
сва-ім	сваім
сввім	сваім
свлім	сваім
свяім	сваім
сяаім	сваім
сааімі	сваімі
свлімі	сваімі
сяаімі	сваімі
сааіх	сваіх
сва-іх	сваіх
сввіх	сваіх
свліх	сваіх
свл-іх	сваіх
свяіх	сваіх
свя-іх	сваіх
снаіх	сваіх
сна-іх	сваіх
спаіх	сваіх
сяаіх	сваіх
саайго	свайго
сваііго	свайго
свай-го	свайго
сванго	свайго
сван-го	свайго
свлйго	свайго
свяйго	свайго
свай-му	свайму
сввту	свату святу
сааю	сваю
сввю	сваю
свзю	сваю
свлю	сваю
свяю	сваю
свед-кам	сведкам
свед-чаць	сведчаць
свелчаць	сведчаць
свсдчаць	сведчаць
свед-чыць	сведчыць
свелчыць	сведчыць
свсжай	свежай
сает	свет
свст	свет
све-там	светам
свет-лай	светлай
свет-лы	светлы
све-ту	свету
свсту	свету
гвеце	свеце
свене	свеце
све-це	свеце
свецс	свеце
свсце	свеце
сві-нарнік	свінарнік
своечасо-ва	своечасова
саой	свой
своіі	свой
свон	свой
саядома-сці	свядомасці
свядомасні	свядомасці
свядо-масці	свядомасці
свя-та	свята
свя-точныя	святочныя
свя-ты	святы
свя-шчэннай	свяшчэннай
сезонс	сезоне
сезо-нс	сезоне
сё-лета	сёлета
сслета	сёлета
сё-летнім	сёлетнім
сельгасарнелі	сельгасарцелі
сельгасарце-лі	сельгасарцелі
сельсаве-та	сельсавета
сельска-гаспадарчай	сельскагаспадарчай
сельскагаспа-дарчай	сельскагаспадарчай
сельскагаспадарчан	сельскагаспадарчай
сельскагаспаларчай	сельскагаспадарчай
ссльскагаспадарчай	сельскагаспадарчай
сельскагяспадарчая	сельскагаспадарчая
сельска-гаспадарчых	сельскагаспадарчых
сельскагас-падарчых	сельскагаспадарчых
сель-скай	сельскай
сельскан	сельскай
сельсквй	сельскай
сельснай	сельскай
ссльскай	сельскай
сель-скіх	сельскіх
ссльскіх	сельскіх
ссльскую	сельскую
селяні-на	селяніна
ссляніна	селяніна
сем'1	сем'і
ссмінар	семінар
се-мянякі	семянякі
сён-іія	сёння
сення	сёння
сён-ня	сёння
ссння	сёння
сён-няшняга	сённяшняга
сё-стры	сёстры
СІгізмундавіч	Сігізмундавіч
сігіз-мундавіч	сігізмундавіч
сіляй	сілай
сіла-мі	сіламі
сі-лы	сілы
сі-манава	сіманава
сімфа-нічнага	сімфанічнага
сі-стэма	сістэма
сі-стэматычна	сістэматычна
сістэматыч-на	сістэматычна
сі-стэму	сістэму
сістзмы	сістэмы
сістэ-мы	сістэмы
ска-жам	скажам
скажлм	скажам
скяжям	скажам
ска-зала	сказала
скаэана	сказана
ска-заў	сказаў
сказзў	сказаў
скаэаў	сказаў
ска-эаў	сказаў
сказаііь	сказаць
сказань	сказаць
сказапь	сказаць
ска-заць	сказаць
сказвць	сказаць
скаэаць	сказаць
скдзаць	сказаць
скан-чэння	сканчэння
сквр-гі	скаргі
скаро-чаны	скарочаны
склчок	скачок
склада-най	складанай
скла-даныя	складаныя
складаюнь	складаюць
скла-ду	складу
скончы-лася	скончылася
скульнтараў	скульптараў
скульнтуры	скульптуры
слаўнан	слаўнай
слаў-ных	слаўных
слаў-ныя	слаўныя
слсд	след
сле-ду	следу
сле-сар	слесар
сле-сары	слесары
слі-вы	слівы
сло-ва	слова
словв	слова
словл	слова
словя	слова
слона	слова
слоаам	словам
словлм	словам
слоаы	словы
словм	словы
сло-вм	словы
слояы	словы
слоў-нік	слоўнік
слоў-ніка	слоўніка
слу-жачых	служачых
служа-чых	служачых
служ-бу	службу
служынь	служыць
слу-жыць	служыць
служэн-ню	служэнню
Слухайцс	Слухайце
слу-халі	слухалі
слу-хаць	слухаць
слуха-ча	слухача
слуха-чам	слухачам
слуцка-га	слуцкага
сма-ленскай	смаленскай
смален-скай	смаленскай
сме-лы	смелы
смернь	смерць
смерню	смерцю
смір-ноў	смірноў
смя-лей	смялей
СокалаКутылоўскага	Сокала-Кутылоўскага
сонеч-ныя	сонечныя
сон-ца	сонца
сонцл	сонца
со-рак	сорак
союэа	союза
спаборнінтва	спаборніцтва
спа-борнінтва	спаборніцтва
спаборніцтаа	спаборніцтва
спаборніцт-ва	спаборніцтва
спаборніцтае	спаборніцтве
спабор-ніцтве	спаборніцтве
спабор-нічаюць	спаборнічаюць
спада-рожнік	спадарожнік
спа-дарожніка	спадарожніка
спада-рожніка	спадарожніка
спада-рожнікі	спадарожнікі
спад-чыны	спадчыны
спа-кою	спакою
спале-ны	спалены
спа-лілі	спалілі
спань	спаць
спа-чатку	спачатку
спачат-ку	спачатку
спек-таклем	спектаклем
слек-таклі	спектаклі
спек-таклі	спектаклі
спектвклі	спектаклі
спсктаклі	спектаклі
спск-таклі	спектаклі
Спсктакль	Спектакль
спсктакль	спектакль
спск-такль	спектакль
спектак-ля	спектакля
спектвкля	спектакля
спсктакля	спектакля
спек-такляў	спектакляў
спсктакляў	спектакляў
спек-таклях	спектаклях
спсктаклях	спектаклях
спецыя-лістамі	спецыялістамі
спеныялістаў	спецыялістаў
спецыялі-стаў	спецыялістаў
спсцыялістаў	спецыялістаў
спецыя-лісты	спецыялісты
спеныяльна	спецыяльна
спецы-яльны	спецыяльны
спе-цыяльным	спецыяльным
спе-цыялыіыя	спецыяльныя
снрава	справа
спра-ва	справа
спрана	справа
спраня	справа
справа-мі	справамі
слраве	справе
снраве	справе
спра-ве	справе
справс	справе
спрлве	справе
снраву	справу
спра-ву	справу
снравы	справы
спра-аы	справы
справм	справы
спра-вы	справы
спрапы	справы
спрввы	справы
спрлвы	справы
справяд-лівасці	справядлівасці
справядлівуіо	справядлівую
спро-ба	спроба
спры-яльныя	спрыяльныя
слрэчкі	спрэчкі
спы-ніць	спыніць
спы-таўся	спытаўся
спя-вання	спявання
спя-ваць	спяваць
спя-шацца	спяшацца
сродка-мі	сродкамі
сролкаў	сродкаў
сролкі	сродкі
ста-віцца	ставіцца
ставінь	ставіць
стагод-дзі	стагоддзі
ста-годдзя	стагоддзя
стаголдзя	стагоддзя
ствгоддзяў	стагоддзяў
стаінь	стаіць
ста-іць	стаіць
ста-лага	сталага
ста-лі	сталі
ста-ліна	сталіна
еталіцы	сталіцы
ста-ліцы	сталіцы
сталі-цы	сталіцы
ствліцы	сталіцы
ста-ловай	сталовай
ста-не	стане
ста-новішча	становішча
стано-вішча	становішча
стано-вяцца	становяцца
станунь	стануць
ста-нуць	стануць
станныі	станцыі
стан-цыі	станцыі
старажыт-нага	старажытнага
старажыт-най	старажытнай
ста-ранна	старанна
ста-рой	старой
ста-ронак	старонак
ста-ронках	старонках
старон-ках	старонках
старшынл	старшына
стар-шынёй	старшынёй
стар-шыні	старшыні
стар-шыню	старшыню
стар-шыня	старшыня
старшы-ня	старшыня
ствршыня	старшыня
ста-рым	старым
ста-рых	старых
старэй-шыя	старэйшыя
стаўлен-не	стаўленне
стаянь	стаяць
ста-яць	стаяць
ствараль-нікам	стваральнікам
стваральнкамі	стваральнікамі
стварань	ствараць
стаарыў	стварыў
стаарыць	стварыць
стварынь	стварыць
ства-рынь	стварыць
ства-рыць	стварыць
стаарэнне	стварэнне
ства-рэнні	стварэнні
стварэн-ні	стварэнні
ства-рэнню	стварэнню
ства-рэння	стварэння
стварэн-ня	стварэння
створа-на	створана
ство-ранай	створанай
створа-ная	створаная
стаораны	створаны
ство-ранм	створаны
ство-рвны	створаны
стнораны	створаны
столь-кі	столькі
страс-ны	страсны
страўнікавакішэчных	страўнікава-кішэчных
странілі	страцілі
стронцый90	стронцый 90
студзень-скага	студзеньскага
студзень-скі	студзеньскі
сту-дыі	студыі
стулыя	студыя
сту-дэнтамі	студэнтамі
стулэнтаў	студэнтаў
студзнты	студэнты
сту-дэнты	студэнты
студэн-ты	студэнты
сты-лі	стылі
СУАНЧЫННІКАМІ	суайчыннікамі
суанчын-нікі	суайчыннікі
суботлх	суботах
суверэні-тэту	суверэнітэту
су-вязей	сувязей
СУВЯЗЕП	сувязей
сувяэей	сувязей
су-вязі	сувязі
сувяэі	сувязі
су-вязь	сувязь
суіс-наванне	суіснаванне
су-месна	сумесна
сум-ленне	сумленне
сумлен-ня	сумлення
сум-нення	сумнення
сумнсння	сумнення
супраноўнік	супрацоўнік
супра-цоўнік	супрацоўнік
супрацоўні-каў	супрацоўнікаў
супрацоўніц-тва	супрацоўніцтва
су-нраць	супраць
супрань	супраць
су-прань	супраць
суп-рань	супраць
супрапь	супраць
су-праць	супраць
суп-раць	супраць
супрвць	супраць
супрлць	супраць
супярэчнасні	супярэчнасці
сур'ёэна	сур'ёзна
сур'сэна	сур'ёзна
суро-вага	суровага
суро-вай	суровай
су-ровыя	суровыя
су-светнага	сусветнага
сусвет-нага	сусветнага
сусветна-га	сусветнага
су-светнай	сусветнай
сус-ветнай	сусветнай
сусвет-най	сусветнай
сусветнвй	сусветнай
сусвет-ны	сусветны
еусветных	сусветных
сусветмых	сусветных
су-свету	сусвету
сустракас	сустракае
сустрака-ем	сустракаем
сустрака-ліся	сустракаліся
су-стракаюцца	сустракаюцца
сустра-каюць	сустракаюць
сустракаючы-ся	сустракаючыся
сустрзлі	сустрэлі
сустрэлі-ся	сустрэліся
суст-рэне	сустрэне
су-стрэў	сустрэў
су-стрэць	сустрэць
су-стрэч	сустрэч
сустрзчу	сустрэчу
сустрэчм	сустрэчы
суст-рэчы	сустрэчы
сустрэ-чы	сустрэчы
сутнасні	сутнасці
сутна-сці	сутнасці
сутнаснь	сутнасць
сут-насць	сутнасць
су-часнае	сучаснае
сучас-нае	сучаснае
сучаснас	сучаснае
су-часнай	сучаснай
сучас-най	сучаснай
сучаснасні	сучаснасці
сучас-насці	сучаснасці
сучаснаснь	сучаснасць
сучас-насць	сучаснасць
сучаснасню	сучаснасцю
су-часнік	сучаснік
су-часную	сучасную
су-часны	сучасны
сучас-нымі	сучаснымі
су-часных	сучасных
схе-му	схему
схо-дзе	сходзе
сходзс	сходзе
снвярджае	сцвярджае
сцвяр-джае	сцвярджае
сцвярлжае	сцвярджае
сцвяр-джаецца	сцвярджаецца
сце-намі	сценамі
снэн	сцэн
снэна	сцэна
снэнарый	сцэнарый
снэ-нарый	сцэнарый
снэне	сцэне
сцэ-не	сцэне
сцэнс	сцэне
сцэ-нічнага	сцэнічнага
снэнічнай	сцэнічнай
сцэ-ну	сцэну
снэны	сцэны
снэ-ны	сцэны
сця-га	сцяга
сцяга-носцам	сцяганосцам
сняне	сцяне
сы-нам	сынам
сэрна	сэрца
сэр-ца	сэрца
сзрцам	сэрцам
сэрнам	сэрцам
сэр-цам	сэрцам
сэр-ны	сэрцы
сюлы	сюды
сюжэ-та	сюжэта
ся-бе	сябе
сябо	сябе
сябс	сябе
сябрв	сябра
сяброу	сяброў
сяб-руе	сябруе
сяб-ры	сябры
ся-джу	сяджу
сядзслі	сядзелі
сядзінь	сядзіць
сядзянь	сядзяць
ся-ло	сяло
сялан	сялян
ся-лянства	сялянства
сямё-навіч	сямёнавіч
ся-мі	сямі
сям'1	сям'і
ся-мігодкі	сямігодкі
сямі-годкі	сямігодкі
сямігод-кі	сямігодкі
ся-мігодку	сямігодку
семнаццаць	сямнаццаць
сяргее-віч	сяргеевіч
Сяргесвіч	Сяргеевіч
Сяргсевіч	Сяргеевіч
Сярген	Сяргей
Снрод	сярод
ся-род	сярод
сярол	сярод
сярэднлй	сярэднай
сярэд-нім	сярэднім
сярэлніх	сярэдніх
ся-рэднюю	сярэднюю
ся-рэдняй	сярэдняй
сярэд-няй	сярэдняй
сярэднян	сярэдняй
сярэлняй	сярэдняй
ся-стру	сястру
ся-стры	сястры
та-бе	табе
табс	табе
твбе	табе
тзбе	табе
та-вараў	тавараў
тава-раў	тавараў
та-варыш	таварыш
та-варыша	таварыша
тава-рышам	таварышам
тава-рышаў	таварышаў
тавары-шаў	таварышаў
тава-рышу	таварышу
тавары-шу	таварышу
тавары-шы	таварышы
таварышыі	таварышы
гаго	таго
та-го	таго
твго	таго
тзго	таго
тлго	таго
та-ды	тады
твды	тады
тяды	тады
тах	так
твк	так
тлк	так
Тлк	Так
тяк	так
твкі	такі
гакім	такім
твкім	такім
тлкім	такім
тякім	такім
гакімі	такімі
гакіх	такіх
тлкіх	такіх
гакія	такія
та-кія	такія
твкія	такія
та-кога	такога
такогя	такога
та-кое	такое
такос	такое
та-кой	такой
твкой	такой
гаксама	таксама
так-сама	таксама
такса-ма	таксама
таксамв	таксама
таксамл	таксама
таксамя	таксама
так-самя	таксама
таксвма	таксама
таксзма	таксама
твксвмв	таксама
тзксама	таксама
тлксама	таксама
тяксама	таксама
та-кую	такую
та-ленавітага	таленавітага
таленаві-ты	таленавіты
твлент	талент
та-лентаў	талентаў
твлен-твў	талентаў
та-лы	талы
твм	там
тлм	там
Тлм	Там
тям	там
та-му	таму
Твму	Таму
твму	таму
тлму	таму
тяму	таму
тансц	танец
таннаў	танцаў
тапа-леўскі	тапалеўскі
Таняна	Тацяна
та-цяна	тацяна
гаямніцы	таямніцы
таямні-чы	таямнічы
гваім	тваім
гвайго	твайго
гвор	твор
таор	твор
гвора	твора
тво-ра	твора
таорамі	творамі
тво-рамі	творамі
твора-мі	творамі
гвораў	твораў
таораў	твораў
тво-раў	твораў
творлў	твораў
тнораў	твораў
гворах	творах
таорах	творах
тво-рах	творах
творвх	творах
тпорах	творах
таорчай	творчай
твор-чай	творчай
тнорчай	творчай
гворчасці	творчасці
таорчасці	творчасці
творчасні	творчасці
творчаспі	творчасці
твор-часці	творчасці
творчас-ці	творчасці
творчлсці	творчасці
Творчаснь	Творчасць
творчаснь	творчасць
твор-часць	творчасць
таорчая	творчая
твор-чую	творчую
таорчы	творчы
твор-чы	творчы
таорчым	творчым
твор-чымі	творчымі
творчы-мі	творчымі
гворчых	творчых
таорчыя	творчыя
твор-чыя	творчыя
таоры	творы
творм	творы
тво-ры	творы
тво--ры	творы
тноры	творы
тяоры	творы
тка-нін	тканін
ткачоу	ткачоў
тлума-чыць	тлумачыць
тос	тое
тоіі	той
голькі	толькі
тольк1	толькі
толь-кі	толькі
тольні	толькі
толь-ні	толькі
тольчі	толькі
тплькі	толькі
трады-цыі	традыцыі
тралыцый	традыцый
трактарна-га	трактарнага
трак-тарыстам	трактарыстам
тра-піць	трапіць
трацінь	траціць
трох-і	трохі
трн	тры
тры-буну	трыбуну
тры-буны	трыбуны
трыва-лай	трывалай
трыво-гі	трывогі
трыс-та	трыста
тры-умф	трыумф
грэба	трэба
трзба	трэба
трэ-ба	трэба
трэбв	трэба
трэ-бв	трэба
трэбз	трэба
трэбл	трэба
Трэбл	Трэба
трэбя	трэба
трэ-цяга	трэцяга
тудысюды	туды-сюды
ту-рыст	турыст
ту-рысты	турысты
турыс-ты	турысты
ты-дзень	тыдзень
гым	тым
тмсяч	тысяч
ты-сяч	тысяч
ты-сячы	тысячы
тыся-чы	тысячы
ты-тул	тытул
тышке-віча	тышкевіча
тэарэтыч-най	тэарэтычнай
гэатр	тэатр
тэ-атр	тэатр
тэвтр	тэатр
гэатра	тэатра
тзатра	тэатра
тэагра	тэатра
тэ-атра	тэатра
тэат-ра	тэатра
тэатрв	тэатра
тэатрл	тэатра
тэвтра	тэатра
тэлтра	тэатра
тэятра	тэатра
тэатралыіага	тэатральнага
тэат-ралыіага	тэатральнага
тэ-атральнага	тэатральнага
Тэатральнамастацкага	тэатральна-мастацкага
тэатральнамастацкага	тэатральна-мастацкага
тэатральнамастацкім	тэатральна-мастацкім
тэат-ральным	тэатральным
тэат-ральных	тэатральных
тэатраль-ных	тэатральных
тэатралыіыя	тэатральныя
тэ-атральныя	тэатральныя
тэат-рамі	тэатрамі
гэатраў	тэатраў
тэат-раў	тэатраў
гэатры	тэатры
тзатры	тэатры
тэ-атры	тэатры
тэвтры	тэатры
тэлтры	тэатры
тэятры	тэатры
тэк-стаў	тэкстаў
тэк-сты	тэксты
тэлебачаннс	тэлебачанне
тэлсбачання	тэлебачання
тэлегра-фа	тэлеграфа
тэле-фоне	тэлефоне
Тэпефоны	Тэлефоны
ТэльАвіва	Тэль-Авіва
ТэльАвіве	Тэль-Авіве
тэмя	тэма
тэ-май	тэмай
тэма-тычны	тэматычны
тэма-тычных	тэматычных
тэма-тычныя	тэматычныя
тэ-му	тэму
тэх-ніка	тэхніка
тэхні-кай	тэхнікай
тэхні-кум	тэхнікум
тэхніч-ны	тэхнічны
тэхніч-ным	тэхнічным
тэх-нічных	тэхнічных
уба-чаць	убачаць
уба-чыць	убачыць
убран-ні	убранні
уввгі	увагі
увягі	увагі
увссь	увесь
удало-ся	удалося
удзсльнікаў	удзельнікаў
удзелыіікі	удзельнікі
удзелыіі-кі	удзельнікі
удзельні-кі	удзельнікі
Удзельнімі	удзельнікі
удзсльнікі	удзельнікі
удзель-нічалі	удзельнічалі
удзельнічань	удзельнічаць
удзяч-ны	удзячны
уз-броеным	узброеным
уэдымам	уздымам
уэнагародзіў	узнагародзіў
уэніміцеся	узніміцеся
узрада-ваўся	узрадаваўся
узрас-ла	узрасла
узрас-тае	узрастае
уэяў	узяў
уэяць	узяць упяць
уклю-чыць	уключыць
укра-інскага	украінскага
украннскмй	украінскай
уксу-саў	уксусаў
ула-дзімір	уладзімір
уладзі-мір	уладзімір
уладэімір	уладзімір
ула-дэімір	уладзімір
ула-дзіміра	уладзіміра
Уладііміра	Уладзіміра
ула-дзімірам	уладзімірам
уладзі-мірам	уладзімірам
ула-ды	улады
улья-наўск	ульянаўск
ума-цоўвайце	умацоўвайце
уме-ла	умела
умсла	умела
умонах	умовах
унівсрсітэт	універсітэт
універ-сітэце	універсітэце
унівсрсі-тэце	унівсрсітэце
упар-тай	упартай
упе-рад	уперад
упер-шыню	упершыню
упершы-ню	упершыню
упсршыню	упершыню
упраў-лення	упраўлення
ура-жанне	уражанне
уражяннем	уражаннем
усс	усе
Усс	Усе
усв	усё
усе-саюзнай	усесаюзнай
усмсшкай	усмешкай
успамі-наў	успамінаў
успом-нім	успомнім
уств-нове	установе
уста-ноў	устаноў
уствноў	устаноў
уств-ноў	устаноў
устаноў-лены	устаноўлены
ус-ход	усход
усю-ды	усюды
усюлы	усюды
уся-го	усяго
уяў-ленне	уяўленне
ўблчылі	ўбачылі
ўба-чыць	ўбачыць
ўва-гі	ўвагі
ўва-зе	ўвазе
ўвай-шоў	ўвайшоў
ўва-ходзіць	ўваходзіць
ўвссь	ўвесь
ўда-ла	ўдала
ўдало-ся	ўдалося
ўдзсл	ўдзел
ўдэел	ўдзел
ўдзсльнікаў	ўдзельнікаў
ўдзяч-насць	ўдзячнасць
ўдзяч-ны	ўдзячны
ўзбраен-няў	ўзбраенняў
ўз-дыму	ўздыму
ўзды-му	ўздыму
ўзна-чальвае	ўзначальвае
ўзначаль-вае	ўзначальвае
ўзро-вень	ўзровень
ўэросту	ўзросту
ўзя-лася	ўзялася
ўзяў-ся	ўзяўся
ўка-ранення	ўкаранення
ўма-цаванне	ўмацаванне
ўмаца-ванне	ўмацаванне
ўма-цавання	ўмацавання
ўмо-вы	ўмовы
ўнутра-най	ўнутранай
ўпер-шыню	ўпершыню
ўпраў-лення	ўпраўлення
ўра-да	ўрада
ўра-даў	ўрадаў
ўра-джай	ўраджай
ўра-жанне	ўражанне
ўражан-нямі	ўражаннямі
ўрачыс-тае	ўрачыстае
ўсс	ўсе
ўеё	ўсё
ўсб	ўсё
ўсе-агульнага	ўсеагульнага
ўссй	ўсей
ўсена-роднай	ўсенароднай
ўсесаюз-най	ўсесаюзнай
ўсі-мі	ўсімі
ўсміхаец-ца	ўсміхаецца
ўспамінм	ўспаміны
ўспа-міны	ўспаміны
ўспамі-ны	ўспаміны
ўспом-ніць	ўспомніць
ўсталя-валася	ўсталявалася
ўста-ноў	ўстаноў
ўста-юць	ўстаюць
ўсв	ўся
ўся-го	ўсяго
ўсягэ	ўсяго
ўтварэн-ня	ўтварэння
ўце-кача	ўцекача
ўча-стка	ўчастка
ўчаст-ка	ўчастка
ўша-ноўвае	ўшаноўвае
ўяў-ленне	ўяўленне
фаб-рыках	фабрыках
фабры-ках	фабрыках
фаб-рыкі	фабрыкі
фабрыны	фабрыцы
фаб-рыцы	фабрыцы
фа-культэта	факультэта
флльклору	фальклору
фартэпія-на	фартэпіяна
фата-графіі	фатаграфіі
фашыз-мам	фашызмам
фашы-стаў	фашыстаў
фа-шысты	фашысты
фа-шысцкай	фашысцкай
фа-шысцкіх	фашысцкіх
фа-шысцкія	фашысцкія
фё-дар	фёдар
фёда-рам	фёдарам
фёда-раў	фёдараў
фе-дэратыўнай	федэратыўнай
фелье-тоны	фельетоны
фер-ме	ферме
фіэічнай	фізічнай
фізіялагіч-ны	фізіялагічны
фі-лармоніі	філармоніі
філврмоніі	філармоніі
філь-маў	фільмаў
фільмс	фільме
філь-мы	фільмы
фор-май	формай
фор-ме	форме
формс	форме
фор-мы	формы
фран-цузскай	французскай
фран-цузы	французы
фраішыі	францыі
ф|юнта	фронта
фрон-та	фронта
фрон-там	фронтам
фроіше	фронце
ха-дзіў	хадзіў
хадзінь	хадзіць
ха-лоднай	халоднай
халае	хапае
ха-пае	хапае
хапас	хапае
ха-равы	харавы
хара-выя	харавыя
харакгар	характар
ха-рактар	характар
ха-рактараў	характараў
харак-тараў	характараў
характа-раў	характараў
характа-ру	характару
хврактару	характару
хярактару	характару
ха-рактары	характары
характа-ры	характары
характа-рыстыка	характарыстыка
ха-рактэрны	характэрны
характэр-ных	характэрных
хармай-стар	хармайстар
хат-ніх	хатніх
ха-це	хаце
ханелася	хацелася
ха-целася	хацелася
хаце-лася	хацелася
хацела-ся	хацелася
хацслася	хацелася
Хацслася	Хацелася
хаалі	хвалі
хвллі	хвалі
хва-люе	хвалюе
хвалюс	хвалюе
хвалююнь	хвалююць
хва-люючую	хвалюючую
хваля-валіся	хваляваліся
хваля-ванне	хваляванне
хаалях	хвалях
хва-лях	хвалях
хві-лін	хвілін
хво-рыя	хворыя
хібв	хіба
хі-міі	хіміі
хлсб	хлеб
хле-ба	хлеба
хлсба	хлеба
хле-бам	хлебам
хлопсц	хлопец
хлоп-цы	хлопцы
хлопчмк	хлопчык
ходзінь	ходзіць
ходэіць	ходзіць
ходзянь	ходзяць
хо-дзяць	ходзяць
хо-ру	хору
хонь	хоць
хо-ча	хоча
хочаіша	хочацца
хочанца	хочацца
хо-чацца	хочацца
хочашіа	хочацца
хо-чуць	хочуць
хранікальнадакументальных	хранікальна-дакументальных
хру-шчова	хрушчова
хрушчо-ва	хрушчова
Хрушчовв	Хрушчова
хру-шчову	хрушчову
хру-шчоў	хрушчоў
хрушчэў	хрушчоў
хут-ка	хутка
хуткв	хутка
хут-касцю	хуткасцю
хут-чэй	хутчэй
хутчэй-шага	хутчэйшага
цалін-ных	цалінных
цалін-ныя	цалінныя
цалі-ну	цаліну
цал-кам	цалкам
цём-кіна	цёмкіна
цемрм	цемры
нёплыя	цёплыя
ціка-ва	цікава
ці-кавага	цікавага
цікаваснь	цікавасць
ціка-васць	цікавасць
цікавасню	цікавасцю
ці-кавасцю	цікавасцю
ціка-васцю	цікавасцю
цікавас-цю	цікавасцю
ці-кавая	цікавая
цікавінь	цікавіць
ціка-віць	цікавіць
ці-кавы	цікавы
ціка-вы	цікавы
цікавы-мі	цікавымі
ці-кавых	цікавых
ціка-вых	цікавых
ціка-выя	цікавыя
цудоў-на	цудоўна
цу-доўная	цудоўная
цудоў-ная	цудоўная
нудоўны	цудоўны
цу-доўны	цудоўны
нудоўных	цудоўных
цу-доўныя	цудоўныя
цулоўныя	цудоўныя
нук-ровыя	цукровыя
цурба-коў	цурбакоў
нымбалаў	цымбалаў
нэлым	цэлым
цэ-лым	цэлым
нэнтнераў	цэнтнераў
цэнт-ра	цэнтра
цэнт-ральнага	цэнтральнага
цэн-тральнай	цэнтральнай
цэнтраль-най	цэнтральнай
цэнт-ральнаму	цэнтральнаму
цэнт-ральны	цэнтральны
нэнтры	цэнтры
ця-бе	цябе
цябс	цябе
ця-гне	цягне
цягнец-ца	цягнецца
няжка	цяжка
цяжкв	цяжка
цяжкл	цяжка
цяжкя	цяжка
цяжкасні	цяжкасці
няжкі	цяжкі
цяж-кім	цяжкім
цяж-кіх	цяжкіх
няжкую	цяжкую
ця-лят	цялят
ііяпер	цяпер
няпер	цяпер
няпср	цяпер
пяпер	цяпер
цнпер	цяпер
цн-пер	цяпер
цялер	цяпер
цянер	цяпер
цяпео	цяпер
ця-пер	цяпер
цяпср	цяпер
цяііер	цяпер цяцер
цяпераш-няе	цяперашняе
ча-вускі	чавускі
ча-го	чаго
чвго	чаго
чакас	чакае
чакаюнь	чакаюць
ча-каюць	чакаюць
чалааек	чалавек
ча-лавек	чалавек
чала-век	чалавек
Чалавок	чалавек
чалавок	чалавек
чалавск	чалавек
чалапек	чалавек
чалаяек	чалавек
чалввек	чалавек
чвлавек	чалавек
чвлв-век	чалавек
чалааека	чалавека
ча-лавека	чалавека
чала-века	чалавека
чалаве-ка	чалавека
чалавекл	чалавека
чалавекя	чалавека
чалавска	чалавека
чала-вска	чалавека
чалавс-ка	чалавека
чаланека	чалавека
чалаяека	чалавека
чаллвека	чалавека
чвлввекв	чалавека
чллавека	чалавека
ча-лавекам	чалавекам
чалавс-кам	чалавекам
чала-векапамывак	чалавекапамывак
чалавекапамы-вак	чалавекапамывак
чалавску	чалавеку
чалявеку	чалавеку
чалавентва	чалавецтва
чалавент-ва	чалавецтва
чалавептва	чалавецтва
чалавецгва	чалавецтва
ча-лавецтва	чалавецтва
чала-вецтва	чалавецтва
чалавец-тва	чалавецтва
чалавецт-ва	чалавецтва
ча-лавецтвам	чалавецтвам
чала-вецтвам	чалавецтвам
ча-лавечага	чалавечага
чалаве-чага	чалавечага
чалавсчай	чалавечай
чалавеч-нага	чалавечнага
ча-му	чаму
члму	чаму
чамусыіі	чамусьці
чамусьні	чамусьці
ча-мусьці	чамусьці
ча-паць	чапаць
чар-гу	чаргу
чарна-баеў	чарнабаеў
чвс	час
члс	час
чяс	час
ча-сам	часам
часлм	часам
часям	часам
Чвсопіс	Часопіс
ча-сопіса	часопіса
ча-сопісах	часопісах
часо-пісе	часопісе
часо-пісы	часопісы
ча-ста	часта
члста	часта
ча-стка	частка
ча-сткі	часткі
част-кі	часткі
ча-стку	частку
ча-су	часу
члсу	часу
часней	часцей
час-цей	часцей
ча-тырох	чатырох
ча-тыры	чатыры
чатыры-ста	чатырыста
чацпвртай	чацвёртай
чорна-га	чорнага
чор-най	чорнай
чор-тава	чортава
чу-жыне	чужыне
чу-жых	чужых
чу-ліся	чуліся
Чухааа	Чухава
чу-юцца	чуюцца
чы-гуначнікаў	чыгуначнікаў
чырво-ная	чырвоная
чыр-воны	чырвоны
чырво-ны	чырвоны
чырво-ным	чырвоным
чырво-ных	чырвоных
чы-стая	чыстая
чы-сты	чысты
чы-стыя	чыстыя
чыта-ла	чытала
чыта-лі	чыталі
чы-тання	чытання
чытань	чытаць
чы-тань	чытаць
чытапь	чытаць
чы-тач	чытач
чыта-ча	чытача
чытлча	чытача
чы-тачам	чытачам
чыта-чам	чытачам
чы-тачоў	чытачоў
чыта-чоў	чытачоў
чытвчоў	чытачоў
чытлчоў	чытачоў
чы-тячоў	чытачоў
чм-тачы	чытачы
чыта-чы	чытачы
чы-таюцца	чытаюцца
чэхасла-вакіі	чэхаславакіі
шаб-лон	шаблон
Шлмякін	Шамякін
шамя-кіна	шамякіна
шарахоускі	шарахоўскі
шара-хоускі	шарахоўскі
Шаўчэпка	Шаўчэнка
шафср	шафер
шахцё-раў	шахцёраў
ша-шы	шашы
шваг-ра	швагра
швей-най	швейнай
швей-ныя	швейныя
ШвейцарыІ	Швейцарыі
шка-да	шкада
школв	школа
школя	школа
шко-лах	школах
шко-ле-	школе
школс	школе
школм	школы
шко-лы	школы
школь-нага	школьнага
школыіікаў	школьнікаў
ІІІмат	шмат
шмвт	шмат
шматлі-кімі	шматлікімі
шмат-лікіх	шматлікіх
шматлі-кія	шматлікія
шмят-лікія	шматлікія
шматтыраж-най	шматтыражнай
шпа-коўскі	шпакоўскі
шта-таў	штатаў
іііто	што
ІІІто	што
інто	што
іпто	што
ІПто	што
ніто	што
піто	што
шго	што
штп	што
штезённа	штодзённа
што-дзённа	штодзённа
штодзённл	штодзённа
штодэённа	штодзённа
штонсбудзь	што-небудзь
штосыіі	штосьці
штосьні	штосьці
штуч-ны	штучны
штуч-ных	штучных
шу-каць	шукаць
шу-му	шуму
шчаслі-вае	шчаслівае
шчаслі-вай	шчаслівай
шча-слівую	шчаслівую
шчасне	шчасце
шчас-цем	шчасцем
шчасня	шчасця
шчаспя	шчасця
шча-сця	шчасця
шчолра	шчодра
шчы-ра	шчыра
шчы-рага	шчырага
шчырасні	шчырасці
шыр-мы	шырмы
шы-рока	шырока
шырокв	шырока
шы-рокага	шырокага
шыро-кага	шырокага
шырока-га	шырокага
шы-рокае	шырокае
шы-рокай	шырокай
шыро-кая	шырокая
шыро-кім	шырокім
шы-рокую	шырокую
шыро-кую	шырокую
шыры-ню	шырыню
эйхма-на	эйхмана
эка-намічнага	эканамічнага
эканаміч-нага	эканамічнага
экана-мічнае	эканамічнае
эка-намічным	эканамічным
экана-мічным	эканамічным
эканаміч-ным	эканамічным
экана-мічных	эканамічных
экано-мікі	эканомікі
эканомі-кі	эканомікі
экэ	экз
экэамены	экзамены
экс-панаты	экспанаты
экс-пануюцца	экспануюцца
эксперы-менталыіага	эксперыментальнага
электрыфіка-цыі	электрыфікацыі
элемен-ты	элементы
эн-гельса	энгельса
энер-гіі	энергіі
эпізол	эпізод
эпізолах	эпізодах
эпо-хі	эпохі
эпо-ху	эпоху
эст-радзе	эстрадзе
эстэ-тычнага	эстэтычнага
эстэ-тычны	эстэтычны
эу-сім	эусім
юна-га	юнага
юна-кі	юнакі
юна-коў	юнакоў
юнац-тва	юнацтва
юііых	юных
Юрын	Юрый
нго	яго
чго	яго
ягп	яго
ядзер-най	ядзернай
ЯДНАПЦЕСЯ	яднайцеся
якасні	якасці
яка-сці	якасці
яклсці	якасці
якас-цях	якасцях
Яклў	Якаў
якан	якая
я-кая	якая
якля	якая
якэя	якая
якяя	якая
яхі	які
які-мі	якімі
якіхнебудзь	якіх-небудзь
пкія	якія
якіч	якія
янія	якія
нкога	якога
якогв	якога
якогя	якога
якос	якое
якоіі	якой
якон	якой
якойнебудзь	якой-небудзь
як-раз	якраз
якраэ	якраз
Якубв	Якуба
якуюнебудзь	якую-небудзь
Ямв	Яма
нму	яму
янв	яна
Янз	Яна
яня	яна
япа	яна
яііы	яны
Яііы	Яны
янм	яны
Янм	яны
я-ны	яны
яньі	яны
япы	яны
яр-кім	яркім
ясня	ясна
ншчэ	яшчэ
чшчэ	яшчэ
яііічэ	яшчэ
яінчэ	яшчэ
яіпчэ	яшчэ
яшч	яшчэ
яшч>	яшчэ
яшчз	яшчэ
яш-чэ	яшчэ